verstricken|to enmesh, to entangle (v~, *str*)
der Unsinn , -|the nonsense (U~)
bullig|brawny, beefy
recken|to elongate, to strain out (r~)
spähen|to peer, to peek, to squint, to spy (s~)
prächtig|splendid, superb, magnificent (prä~)
aufdecken|to unhide, to unveil, to reveal
unerträglich|unbearable
etliche|several, a number of (et~)
der Nichtsnutz , -e|the good-for-nothing
schaudern|to shudder, to shiver
aufkreuzen|to show up, to appear (a~)
fernhalten|to keep away, to hold off
die Berührung , -en|the touch, the contact
trüben|to tarnish, to dim
aufschlagen|(1) to hit (2) to serve (sports) (3) to open (book or newspaper)
wolkenverhangen|overcast, cloud-covered
das Vorzeichen , -|the omen, the sign (V~)
summen|to hum, to buzz (s~)
schwatzen|to chat, to gossip (s~, *wa*)
munter|perky, alert, lively
schreiend|screaming
rangeln|to jockey for position
zwingen|to force (z~)
der Waldkauz , -"e|the tawny owl
der Schmatz , -e|the snacking kiss
der Abschiedskuss , -"e|the goodbye kiss
der Wutenfall , -"e|the tantrum
der Haferbrei , -|the porridge
bewarf|pelted, bombarded
der Schlingel , -|the scamp, the rascal
die Einfahrt , -en|the entry, the driveway (E~)
die Einbiegung , -en|the inward bend
die Sinnestäuschung , -en|the trick of the senses
der Ruck , -e|the jolt, the jerk, the yank
verjagen|to expel, to chase away (v~)
eintreffen|to turn up, to arrive (e~)
der Stadtrand , -"er|the city outskirts
verdrängen|to suppress, to supersede, to oust (v~)
bemerken|to notice, to observe (b~)
offenbar|obvious(ly), evident(ly) (o~, *r)
ausstehen|to bear, to abide, to endure (a~)
herausputzen|to dress up, to array, to smarten
aussuchen|to pick out, to choose
auffallen|to stand out, to strike, to attract attention
die getigerte Katze|the tabby cat (no plural) (d~ g~ K~)
der Auftrag , -"e|the order, the commission, the assignment
üblich|usual, common (ü~)
festsitzen|to be stuck, to be jammed tight
der Umhang , -"e|the gown, the cloak, the cape
die Menge , -n|(1) the amount, the quantity (2) the crowd (3) the lot (M~)
anziehen|(1) to attract (2) to get dressed
trommeln|to thrum, to drum, to pound
das Lenkrad , -"er|the steering wheel
die Ansammlung , -en|the gathering, the cluster, the crowd (A~)
die Gestalt , -en|(1) the shape, the form (2) the figure, the person
aufgeregt|excited
flüstern|to whisper (f~)
erzürnt|enraged, angered
feststellen|to ascertain, to determine, to assess (f~)
smaragdgrün|emerald green
einfallen|(1) to come to mind, to think of, to remember (2) to collapse, to fall in, to shrink
die Verkleidung , -en|(1) the disguise (2) the cladding, the casing
andernfalls|otherwise, in the other case (a~, *fa*)
schwergefallen|been difficult (past-p)
schießen|to shoot past
wohl aber|but rather (w~ a~)
deuten|to point, to indicate
hinwegfliegen|to fly across, to fly away
verbrauchen|to consume, to spend
gewöhnlich|ordinally (g~)
zur Schnecke machen|to bawl out, to tear a strip out of (z~ S~ m~)
schreien|to scream
glänzend|radiant, glossy, shiny
die Laune , -n|the mood, the whim (L~)
sich die Beine vertreten|to stretch one's legs (coll.) (s~ d~ B~ v~)
der Krapfen , -|the doughnut
die Aufmachung , -en|the make-up, the get-up, the style
begegnen|to encounter
im Vorbeigehen|in passing (i~ V~)
bereiten|to prepare (b~)
das Unbehagen , -|the discomfort, the unease
tuscheln|to whisper secretly (t~)
die Sammelbüchse , -n|the collection box
aufschnappen|(1) to overhear (2) to snap open
wie angewurzelt stehen bleiben|to stop dead in one's tracks (w~ a~ s~ b~)
als ob|as if (a~ o~)
sich besinnen|to bethink, to reflect (s~ b~)
hastig|hastily
anfauchen|to snarl at, to spit at
schon fast|almost (s~ f~)
streicheln|to stroke, to caress
beunruhigen|to alarm, to upset, to worry (b~)
außer sich|beside himself (a~ s~)
geraten|(1) to get into, to turn out (2) advised
erwähnen|to mention
der Vorwurf , -"e|the blame, the reproach
dennoch|nevertheless, however (d~)
um einiges|considerably, significantly (u~ e~)
richten|to focus, to straighten, to adjust, to judge
immer noch|still (i~ n~)
der Schritt , -e|the step, the stride
gleich|(1) equal, similar, identical (2) immediately
zusammenprallen|to collide with, to bounce against
ins Stolpern kommen|to stumble, to come to a stumble (i~ S~ k~)
beinahe|nearly, almost
hinfallen|to tumble, to fall over
erst|(1) first (2) only (3) just
umstoßen|to overturn, to overthrow
scheinen|(1) to seem, to appear (2) to shine
ärgern|to spite, to annoy, to aggravate
aufblicken|to look up, to raise one's eyes
piepsig|squeaky (of a voice)
verzeihen|to forgive
die Bahn , -en|(1) the train (2) the railway (3) the way
selbst|(1) even (2) self, themselves, etc
du-weißt-schon-wer|you-know-who
freudig|joyful, joyous
feiern|to celebrate
von dannen|away, off (v~ d~)
anwurzeln|to get rooted, to take root
völlig|utter, complete, fully, completely (v~)
der/die Fremde(r)|the stranger (adj. decl.)
halten|to hold, to keep
durcheinander|confused, flustered, upset (d~)
eilen|to hurry
die Einbildungskraft , -"e|the imagination (E~, *ft)
einbiegen|to turn into (a street etc.)
die Auffahrt , -en|the driveway, the ramp, the access road (A~)
als Erstes|first of all (a~ E~)
gerade|exactly, just, straight, direct, erect
die Mauer , -n|the wall, the mural
gewiss|certain, surely, certainly
das Muster , -|the pattern
zischen|to hiss
sich regen|to bestir oneself, to stir (s~ r~)
anblicken|to glare at, to stare at (anb~)
ernst|serious, severe, stern
sich zusammenreißen|to pull oneself together (s~ z~)
entschlossen|determined, resolute (e~, *lo*)
nichts von alledem|none of these things (n~ v~ a~)
erzählen|to tell (a story), to narrate
der Zauberer , -|the wizard
nachdem|after, after this, as, because
das Neueste|the latest (no plural)
die Abendnachrichten|the evening news (plural)
ansehen|to face, to look at, to inspect, to watch (a~)
der Vogelkundler , -|the bird watcher (male)
berichten|to report, to give an account (b~)
sich verhalten|to behave, to act (s~ v~)
jagen|to hunt
tagsüber|by day, during the daytime (long form)
der Sonnenaufgang , -"e|the sunrise
das Mal , -e|the time, the occasion
kreuz und quer|criss-cross (k~ u~ q~)
die Gewohnheit , -en|the habit (G~)
sich erlauben|to allow oneself, to permit oneself
das Grinsen , -|the grin, the smirk
noch weiter|further (n~ w~)
erwarten|to expect, to anticipate
der Wetteransager , -|the weatherman
seltsam|odd, strange
die Gegend , -en|the region, the area (Ge~)
anrufen|to call, to telephone
anstelle|in place of, instead of (a~, *e)
versprechen|to promise
der Schauer , -|(1) the shower (rain) (2) the awe, the shudder
die Sternschnuppe , -n|the shooting star
niedergehen|to fall (rain), to go down
eine Weile hin|a while off (e~ W~ h~)
regnerisch|rainy
starr|rigid, stiff
der Eiszapfen , -|the icicle
allerorten|everywhere, all places (a~)
sonderbar|weird, odd (so~)
das Tuscheln , -|the whisper (T~)
Es hatte keinen Zweck.|It would be no good. (idiom) (E~ h~ k~ Z~)
sich räuspern|to clear one's throat, to cough slightly
in letzter Zeit|lately, as of late (i~ l~ z~)
befürchten|to fear (b~)
entsetzt|appalled, horrified
schließlich|eventually, finally, after all (s~)
scharf|(1) sharp, severe, harsh (2) spicy (3) keen
das Zeug , -e|the stuff, the gear
komisch-aussehend|funny-looking
anfahren|(1) to approach (2) to start (car) (3) to snap at, to snarl at
der Klüngel , -|the clique (K~)
nippen|to sip, to nip
geschürzt|pursed
wagen|to dare, to venture, to risk
stattdessen|instead (s~, *n)
beiläufig|casual, casually
steif|stiff
noch mal|once again (n~ m~)
hässlich|ugly
Das Herz rutschte mir in die Hose.|My heart missed a beat. (idiom) (D~ H~ r~ m~ i~ d~ H~)
rutschen|to slip, to slide, to skid (r~)
Ich bin ganz deiner Meinung.|I completely agree with you. (idiom) (I~ b~ g~ d~ M~)
schleichen|to sneak, to creep (sc~)
herauskommen|to emerge, to come out
verwandt|related
ertragen|to bear, to suffer, to tolerate, to endure (e~)
einschlafen|to fall asleep (e~)
rasch|rapid, rapidly
wach|awake
wälzen|to roll, to toss, to turn in one's mind (w~)
noch einmal|once again (n~ e~)
tröstend|soothing, comforting
auftauchen|to emerge, to surface, to turn up, to appear
ihresgleichen|people like her, people like them
irgendetwas|anything (i~)
hineingeraten|to get into, to get involved with
vor sich gehen|to occur, to go on, to take place (v~ s~ g~)
dort draußen|out there (d~ d~)
gähnen|to yawn
drehen|to spin, to turn, to twist (d~)
jedenfalls|at any rate, anyway
sich täuschen|to delude oneself, to be wrong about
hinübergleiten|to glide over
die Spur , -en|the track, the track, the hint
die Müdigkeit|the tiredness, the fatigue (no plural)
blinzeln|to blink, to squint
das Härchen , -|the little hair
zuknallen|to slam shut (zuk~)
schwirren|to buzz, to whirr (sc~)
in der Tat|as a matter of fact (i~ d~ T~)
rühren|(1) to stir (2) to move (a body part)
zum ersten Mal|for the first time (z~ e~ M~)
jäh|precipitously, suddenly (j~)
lautlos|noiseless, silent
der Boden , -"|(1) the soil (2) the ground (3) the floor
wachsen|to grow
geradewegs|straight, direct (g~, *gs)
zucken|to jerk, to twitch
verengen|to constrict, to narrow
der Schlitz , -e|the slot, the slit
noch nie|never before
...nach zu schließen|judging by... (idiom) (n~ z~ s~)
der Gürtel , -|the belt
stecken|to stick, to put
purpurrot|crimson
streifen|(1) to brush, to graze, to touch lightly (2) to stripe (3) to range, to roam
der Stiefel , -|the boot
die Schnalle , -n|the buckle, the clasp
die Hacke , -n|(1) the heel (2) the hoe
funkelnd|sparkling, glittering
halbmondförmig|crescent-shaped
das Brillenglas , -"er|the glasses lense
hervor|forth (h~)
krumm|crooked (k~)
soeben|just, just now
keineswegs|by no means
gedankenverloren|to be lost in thought
durchstöbern|to rummage, to browse through (*ö*)
aus irgendeinem Grund|for some reason (a~ i~ G~)
der Anblick , -e|the sight, the view, the perspective (Anb~)
belustigen|to amuse, to make laugh
glucksen|to chuckle, to chortle
vergnügt|jolly, gleefully, cheerful (v~)
wonach|whereupon, after which
das Feuerzeug , -e|the lighter
aussehen|to look (like), to appear
der Deckel , -|the lid, the cap, the cover
knipsen|to take a photograph, to snap
ausgehen|(1) to go out (2) to date (romance) (3) to fade (a~)
flackern|to flicker, to flare (fla~)
erlöschen|to expire, to lapse, to die off
zwölfmal|twelve-times
einzig|sole, only, single, lone
der Stecknadelkopf , -"e|the pinhead (S~)
scharfäugig|beady-eyed, sharp sighted
mitbekommen|to witness, to catch, to realize
gleiten lassen|to slide (g~ l~)
sich setzen|to sit down, to seat oneself (s~ s~)
zulächeln|to smile at
ernst dreinblickend|serious-looking (e~ d~)
recht|(1) right (2) rightly, fairly, rather
dasitzen|to sit there
die Backsteinmauer , -n|the brick wall (B~)
verärgert|angry, upset, annoyed (v~)
schnauben|to snort (s~)
ungeduldig|impatient
vorsichtiger|more careful (v~)
los|off (l~)
deuten|to point, to indicate
rucken|to jerk, to jolt
der Vorwurf , -"e|the blame, the reproach
Ich mache ihnen keinen Vorwurf.|I don't blame them. (I~ m~ i~ k~ V~)
herzlich wenig|a fat lot, precious little
reizen|to irritate (r~)
unvorsichtig|careless (unv~)
sich herumtreiben|to hang about, to rove about (s~ h~)
das Gerücht , -e|the rumor
zum Besten geben|to present to others (song etc) (idiom) (z~ B~ g~)
zuwenden|to face, to turn towards (z~)
dabei|thereby, at that, at the same time
mitteilen|to inform, to confide, to impart (m~)
schweigen|to be silent (s~)
fortfahren|to proceed, to continue (f~, *hr*)
die Bescherung , -en|the giving of presents at Christmas
ausrechnen|to calculate, to work out (a~)
ausgerechtnet|(1) calculated (2) just (a~)
es sieht danach aus|it seems like it (e~ s~ d~ a~)
vieles|many things
die Brause , -n|the sherbet
die Nascherei , -en|the treat, the nibble
richtig|correct, right, real, true
dazu|thereto, as well, in addition
dauernd|constantly (d~)
einsehen|to realize, to see, to understand
davor|before it, beforehand
aussprechen|to pronounce
aufgebracht|upset, angry (a~)
bewundern|to admire (b~)
anders|different, else, unlike, otherwise
fürchten|to fear, to dread (f~)
schmeicheln|to flatter
einsetzen|(1) to appoint (2) to deploy, to utilize (3) to insert, to install (4) to put at stake
die Ohrenschützer|the earmuffs (pl)
gefallen|to please, to be pleasing, to appeal
umherfliegen|to fly around (u~)
erreichen|to reach (a goal), to achieve
unbedingt|absolutely, unconditionally
weder... noch...|neither... nor...
durchdringend|pervasive, penetrating
dringend|urgent
festnageln|to pin down (f~)
offensichtlich|obviously, obvious (o~ , *h)
was auch immer|whatever (w~ a~ i~)
drängen|to urge, to press, to push, to crowd
die Suche , -n|the quest, the search
zufolge|according to (z~)
senken|to lower, to sink, to reduce, to declide
stocken|to falter, to stop, to pause (s~)
ausstrecken|to stretch out, to reach out
belegt|(1) occupied, staffed, assigned (2) breathy, husky
zitternd|trembling
zusammenfallen|(1) to collapse (2) to coincide
deshalb|therefore, for this reason (d~)
düster|gloomy, sombre
die Miene , -n|the facial expression (mien)
umbringen|to slay, to kill
wie um Himmels willen|how on Earth, how in heaven (idiom) (w~ u~ H~ w~)
mutmaßen|to assume, to conjecture
hervorziehen|to pull out, to pull forth (from behind/under)
das Spitzentaschentuch , -"er|the lace handkerchief
betupfen|to dab at, to fleck
schniefen|to sniff, to sniffle
merkwürdig|peculiar, strange (m~)
der Zeiger , -|(1) the pointer (2) the clockhand
die Ziffer , -n|the digit, the numeral
drehen|to spin, to turn, to revolve
sich verspäten|to be late, to be delayed (s~ v~)
hierherkommen|to come here, to approach (hi~)
bleiben|to remain, to stay
ähneln|to resemble
quälen|to torture, to torment
die Süßigkeit , -en|the sweet, the candy
wiederholen|to repeat, to do again
erlahmen|to languish, to wane, to grow weak
die Legende , -n|the legend
sich wundern|to be surprised, to wonder, to marvel
heutige|today's, contemporary
verdrehen|to twist, to warp, to distort (v~, *d*)
aufwachsen|to grow up
begreifen|to grasp, to understand, to comprehend (b~)
schlucken|to swallow, to gulp
verstecken|to hide, to stash (v~, *s*)
darunter|under it, beneath it
klug|clever, smart, prudent (k~)
für etwas halten|to think something is (f~ e~ h~)
anvertrauen|to entrust, to confide
behaupten|to claim, to assert (beh~)
grummeln|to grumble
umsichtig|prudent, judicious
neigen dazu|to tend to, to be prone to (n~ d~)
zerbrechen|to shatter, to snap, to break up
das Brummen , -|the hum, the buzz, the drone
die Stille , -n|the silence, the stillness (St~)
herunterschauen|to look down
der Lärm|the noise, the racket (L~) (no plural)
anschwellen|to swell up, to bulge, to rise, to crescendo
das Dröhnen , -|the roar, the din, the clang, the boom (D~)
riesig|huge, enormous (r~)
gewaltig|vast, tremendous, enormous (g~)
breitbeinig|straddle-legged, with one's legs apart
darauf|on it, upon it, thereon, thereafter
verboten|forbidden, banned
verdecken|to blanket, to cover, to conceal
die Strähne , -n|the strand, the streak
ausladend|sprawling, sweeping
muskelbepackt|musclebound, ripped
das Bündel , -|the bunch, the bundle
das Leintuch , -"er|the bedsheet (Le~)
erleichtert|relieved
borgen|to borrow (b~)
klettern|to climb, to clamber
herausholen|to get out, to withdraw, to fetch out (from out of something) (*ho*)
anschwirren kommen|to come buzzing, to come flying along
neigen|slant, to lean towards
darin|in it, therein
das Büschel , -|the clump, the tuft, the cluster
rabenschwarz|jet black (r~)
der Schnitt , -e|(1) the cut, the incision (2) the haircut
der Blitz , -e|the lightning, the thunderbolt
die Narbe , -n|the scar
oderhalb|atop, above
tadellos|impeccable, faultless
hinter|behind
zuwenden|to turn towards, to face (z~)
beugen|(1) to bend (2) to bow
struppig|shaggy, ragged (s~)
gewiss|certain, confident
kratzig|scratchy, rough
ausstoßen|(1) to emit (gas, fumes) (2) to utter (cry, howl) (3) to eject
das Heulen , -|the howl, the whine
aufwecken|to wake up, to rouse
gepunktet|dotted, spotted
vergraben|to bury (v~)
fassen|(1) to grasp, to grip (2) to comprehend, to understand (f~)
behutsam|cautious, gentle (b~)
niedrig|(1) low, small (2) menial
der Vordereingang , -"e|the front entrance
treten|to tread, to step
zurückkehren|to turn back, to return
kehren|to sweep, to turn (change) (k~)
die beiden anderen|the other two
heftig|fierce, severe
erloschen|expired, terminated, extinct
schließlich|eventually, finally
die Feier , -n|the celebration
dumpf|dull, muffled
die Kiste , -n|the crate, the box, the chest (Ki~)
am besten|best (a~ b~)
wegbringen|to bring away, to carry off
wischen|(1) to wipe (2) to mop
tropfnass|dripping wet
schwingen|(1) to swing, to sway (2) to wield, to brandish
erwecken|to arouse, to inspire, to awaken
erheben|to raise, to elevate
donnern|to thunder, to boom
nicken|to nod
entfernen|to remove, to get off (e~)
stehenbleiben|to stop still (s~, *bl*)
hervorholen|to fetch out, to take out (from behind something) (*ho*)
huschen|to scurry, to flit, to dart (hu~)
mit einem Mal|all of a sudden (m~ e~ M~)
streichen|to stroke, to roam, to sweep, to paint, to withdraw
die Türschwelle , -n|the doorstep, to threshold
der Absatz , -"e|(1) the paragraph (2) the heel (shoe) (3) the landing (of a house)
die Brise , -n|the breeze
kräuseln|to ripple, to ruffle, to frill, to curl
sorgfältig|meticulous, thorough
die Hecke , -n|the hedge
daliegen|to lay there
klammern|to cling onto, to clamp, to clasp
wissend|knowing, aware
der Vetter , -n|the cousin
peinigen|to distress, to anguish, to torment
piesacken|to badger, to annoy, to tease
in ebendies|in this very
stattfinden|to occur, to take place, to happen (s~)
gedämpf|subdued, muffled, muted
die Versammlung , -en|the assembly, the gathering (V~)
die Schwelle , -n|(1) the threshold, the verge (2) the doorstop
fein|fine, subtle
säuberlich|cleanly, neatly
geplegt|groomed, neat, tidy
das Messingschild , -er|the brass sign
erglimmen|to light up, to begin to glow (e~, *g*)
kriechen|to crawl, to creep (kri~)
genauso|equally, just the same as, in the same way
unheilvoll|ominous (u~)
der or das Kaminsims , -se|the mantlepiece (two genders)
vor Augen führen|to visualize (idiom) (v~ A~ f~)
an etwas erinnern|to be reminiscent of something (a~ e~ e~)
der Strandball , -"e|the beach ball
der Bommelhut , -"e|the bobble hat
knuddeln|to cuddle
küssen|to kiss
ahnen|to anticipate, to suspect, to sense
dalli|pronto
hellwach|wide awake
kreischen|to screech, to squeal, to shriek (k~)
der Rücken , -|the back, the spine
fliegend|flying
vorkommen|to occur, to be found, happen (v~)
schon wieder|yet again (s~ w~)
auf den Beinen sein|astir, to be on one's feet (idiom) (a~ d~ B~ s~)
der Schinken , -|the ham, the gammon
auf etwas aufpassen|to be mindful of something, to look out for something (a~ e~ a~)
anbrennen|to burn (a~)
ja|(1) surely (2) certainly (3) yes
verstreichen|(1) to elapse, to pass (time) (2) to spread (on food)
stöhnen|to groan, to moan in annoyance
keifen|to nag, to scold
wegzupfen|to pluck off, to pick off
gewöhnen|to accustom, to acclimate
wimmeln|to swarm, to be teeming with
der Flur , -e|the hallway, the corridor (F~)
betreten|(1) to tread (2) to enter (a room) (3) embarrassed
über und über|all over (idiom) (ü~ u~ ü~)
bedecken|to cover, to coat
das Geschenk , -e|the gift, the present
das Rennrad , -"er|the road bike
nicht der Rede wert|not to mention, nothing to speak of (idiom) (n~ d~ R~ w~)
verabscheuen|to abhor, to detest
reinhauen|(1) to tuck in (food) (2) to smash, to thump
Darum geht's.|That's the point. That's what it's all about. (idiom) (D~ g~)
dürr|scrawny, lean
gewesen|been (sein past-p)
abgelegt|discarded (ab~)
die Klamotte , -n|the rag, the old clothing, the junk
schmal|narrow, slender (s~)
knubbelig|knobbly
das Klebeband , -"er|the cellotape (K~)
das Aussehen , -|the appearance, the look
sterben|to die
aufhören|to stop (au~, *ö*)
Leben fristen|to eke out an existence (L~ f~)
umdrehen|to turn over, to upend, to reverse (u~, *d*)
bellen|to bark, to snap
der Gruß , -"e|the greeting
wuchern|to proliferate, to sprawl, to grow rampant
auffällig|conspicuous, noticeable (a~, *ig)
dicht|(1) dense, thick (2) close
glatt|smooth (gl~)
die Perücke , -n|the wig
unterdessen|meanwhile (u~)
eine Schute ziehen|to pout, to pull a sulk (e~ S~ z~)
Schau!|Look!
rot anlaufen|to blush, to turn red (r~ a~)
nach Art von|in the style of (n~ A~ v~)
schlingen|(1) to gobble, to gulp (2) to loop, to noose
für den Fall, dass|just in case that (f~ d~ F~, d~)
hinunter|down, under, to the bottom (hi~)
umkippen|(1) to overturn, to upend (2) to faint, to collapse
wittern|to sense, to scent, to perceive
die Gefahr , -en|the hazard, the danger
das Spätzchen , -|the little sparrow
schwerst|most heavily
der Süßer , -|the cutie, the sweety
sich plumpsen lassen|to flop oneself, to plonk oneself down on (s~ p~ l~)
grabschen|to grope, to snatch
das Päckchen , -|the parcel, the packet (Pä~)
Von mir aus.|Fine with me. For all I care. (idiom) (V~ m~ a~)
der Lümmel , -|the tyke, the lout
klingeln|to ring
der Apparat , -e|the device, the apparatus, the telephone
ferngesteuert|remote-controlled
auspacken|to unpack, to unwrap
zornig|furious, angry (z~)
besorgt|worried, anxious (b~, *t)
unwirsch|harsh, unkind
aufklappen|to open out, to fold out
der Schreck , -e|(1) the fear (2) the shock
hüpfen|to hop, to skip
bestehen|(1) to insist (2) to pass (exam) (3) to persist, to overcome (4) to exist
der Kohl , -|the cabbage
je|ever, each
die Unannehmlichkeit , -en|the inconvenience
aushecken|to concoct, to contrive, to hatch (a plan)
sich leidtun|to feel sorry for oneself
angucken|to look at
vorschlagen|to suggest (v~)
oder vielmehr|or rather, or a greater degree (o~ v~)
widerwärtig|despicable, disgusting (w~, *g)
die Schnecke , -n|the snail, the slug
dann|then
die Abwechslung , -en|the variety, the variation, the change
sich über etwas hermachen|to tacke something, to get one's teeth into something (s~ ü~ e~ h~)
die Trümmer|the debris, the ruins (plural)
raunzen|to moan, to grumble (r~)
in der Luft jagen|to blow up (idiom) (i~ d~ L~ j~)
nicht in Frage kommen|to be out of the question, to be impossible (idiom) (n~ i~ F~ k~)
drinbleiben|to stay indoors
zwar|admittedly, indeed (zw~)
jammern|to complain, to whine, to wail (j~)
verderben|to spoil, to ruin
markerschütternd|blood-curdling
der Schluchzer , -|the sob
gehässig|hateful, spiteful
zuwerfen|to throw to
läuten|to chime, to ring
Ach du liebes bisschen!|Good gracious! (idiom) (A~ d~ l~ b~)
hellauf|highly (enthusiastic, indignant)
marschieren|to march
die Begleitung , -en|(1) the companionship, the chaperon (2) the accompaniment (music)
mager|meagre, thin, lean
die Ratte , -n|the rat
festhalten|to hold fast, to hold on, to adhere, to clutch, to adhere
einschlagen|(1) to strike, to smash, to batter (2) to take/choose a path
aufbrechen|(1) to leave, to part (2) to break open
beiseite|aside
nahe|near, close by
die Kleinigkeit , -en|(1) the trifle (2) the little thing
jemand|(1) someone, somebody (2) anyone, anybody
geschehen|to occur, to happen (g~)
wieder einmal|once again, yet again (w~ e~)
der Überdruss , -|the weariness, the tedium (Ü~)
die Schere , -n|the scissors, the shear
greifen|to grasp, to grab
die Glatze , -n|the baldhead, the skinhead
noch etwas|any more, some more (n~ e~)
dämlich|dopey, dumb, dimwitted, stupid
das Auge , -n|the eye
ohnehin|anyway (o~)
Er würde ihm schlecht ergehen.|He would fare badly. (E~ w~ i~ s~ e~)
ausgebeult|baggy
geklebt|glued
hänseln|to tease (h~)
aufwachen|to awake, to wake up (a~)
vorfinden|to discover, to find (v~)
absäbeln|to hack off, to cut off
ein andermal|another time, some other time
eklig|yucky, icky
der or die Bommel , -n|the bobble (two genders)
zwängen|to worm, to wedge (in), to squeeze (in)
verzweifelt|desperate, frantic (v~)
sich mühen|to toil, to strive, to struggle (s~ m~)
die Puppe , -n|the doll
passen|(1) to fit, to suit (2) to pass
einlaufen|to shrink (clothes)
das Waschen , -|the washing
die Erleichterung , -en|the relief (from anxiety or pain)
andererseits|otherwise, on the other hand (a~, *se*)
die Schwierigkeit , -en|the trouble, the difficulty
die Bande , -n|the gang, the posse (B~)
auf einmal|all at once, suddenly (a~ e~)
ebenso|likewise, alike, equally
verdutzt|puzzled, baffled
alle anderen|all the others, everybody else
der Kamin , -e|the chimney, the fireplace
bekommen|to receive, to get
daraufhin|subsequently, consequently (d~)
empor|upwards, aloft (e~)
verschlossen|locked, sealed (v~)
der Abfalleimer , -|the dustbin (A~)
zurufen|to hail, to call out
überlegen|(1) to consider, to reflect (2) superior, outstanding
der Sprung , -"e|the jump, the leap
erfassen|to capture, to gather (er~)
getragen|(1) second-hand (2) carried
schiefgehen|to go pear-shaped, to go awry
bloß|mere, merely, just (b~)
riechend|smelling, odourious
verbringen|to spend
die Gesellschaft , -en|the society, the association, the company
in Kauf nehmen|to put up with, to accept (idiom) (i~ K~ n~)
sich beschweren|to complain, to encumber oneself (s~ b~)
sich beklagen|to complain, to bleat, to bemoan (s~ bek~)
der Stadtrat , -"e|the city council
jagen|(1) to hunt (2) to chase (3) to speed
der Verrückter , -|the maniac, the lunatic (V~)
Hier lang!|This way! (coll.) (H~ l~)
klagen|to complain (k~)
einige|some, several, a few of (ei~)
überholen|to overtake
knallen|to bang, to crack (kn~)
der Vordermann , -"er|the person in front
der Sitz , -e|the seat
nach hinten|to the back, backwards (n~ h~)
die Scheibe , -n|(1) the disc (2) the plate
die Rote Bete|the beetroot (sing. only)
anschreien|to shout at
wiehern|to whinny, to neigh
sich verhalten|to behave (s~ v~)
gefährlich|dangerous, hazardous
die Gedanke , -n|the thought, the notion, the idea
auf etwas kommen|to remember something (a~ e~ k~)
egal ob|regardless of whether (e~ o~)
sonnig|sunny
der Sonnabend , -e|the Saturday (not Samstag)
drängeln|to scramble, to shove (d~)
Schoko-|Chocolate-
die Eiskugel , -n|the scoop of ice cream
der Eiswagen , -|the ice cream truck
das Eis am Stiel|the lolly, the popsicle (sing. only) (d~ E~ a~ S~)
der Stiel , -e|the stem, the shaft, the handle
lutschen|to suck (l~)
erstaunlich|astonishing, amazing
auch wenn|even though, although, even if (a~ w~)
seit langem|for a long time (s~ l~)
hinten hergehen|to walk along behind (h~ h~)
die Beschäftigung , -en|the occupation, the employment
verhauen|to whack, to spank
verfallen|(1) to decay, to deterioate (2) to lapse (v~, *ll*)
der Eisbecker , -|the sundae, the ice cream bowl
aufessen|to eat up, to finish off
des Guten zu viel sein|to be overkill, to be over the top (idiom) (d~ G~ z~ v~ s~)
im Nachhinein|in hindsight, retrospectively
drin|within, inside (d~, not drinnen)
beleuchtet|illuminated, lit
das Sichtfenster , -|the observation window
eingelassen|embedded, flush-mounted
die Art , -en|the kind, the type
die Echse , -n|the lizard
der Ast , -"e|the branch (A~)
zerquetschen|to squash, to squish (z~)
die Pythonschlange , -n|the python (snake)
die Kobra , -s|the cobra (snake)
der Mülleimer , -|the rubbish bin (M~)
quetschen|to squeeze, to squash, to bruise (q~)
dazu|to it, in addition, as well
nicht gerade|not exactly, not quite (n~ g~)
nicht in Stimmung|not in the mood (n~ i~ S~)
tatsächlich|actually, in fact, indeed
dösen|to doze
vor sich hin|away to oneself (v~ s~ h~)
gebannt|spellbound, mesmerized (g~)
die Windung , -en|the coil, the winding, the twisting, the torsion
quengelnd|grouching, gruzzling
der Tropfen , -|the drop, the bead, the blob
die Faust , -"e|the fist
befehlen|to order, to command
behände|nimble, agile (b~)
schnarchen|to snore
schlurfen|to shuffle, to drag one's feet
ruhen|to rest, to lie still
ruhen lassen|to let rest, to allow to rest (r~ l~)
die Langweile , -n|the tediousness (L~)
doof|dumb, silly, like a doofus
stören|to disturb, to interrupt, to disrupt, to bother
schlimmer|worse
das Perlauge , -n|the pearl-eye
allmählich|gradual, gradually
ganz allmählich|little-by-little (idiom) (g~ a~)
heben|to lift, to raise, to hoist (he~)
zwinkern|to wink
die Schulter , -n|the shoulder
stoßen|to thrust, to bump, to poke, to jab
nach oben|to the top, upwards (n~ o~)
eindeutig|clear, unambiguous
auf die Palme bringen|to drive up the wall (idiom) (a~ d~ P~ b~)
lebhaft|lively, brisk, vivid
der Schwanz , -"e|the tail (S~, *z*)
die Inschrift , -en|the inscription
ausbrüten|to hatch, to incubate
erschallen|to resound, to ring out
ohrenbetäubend|deafening, ear-shattering
zusammenzucken|to wince, to cringe (long form)
watscheln|to shamble, to woddle
die Rippe , -n|the rib
drücken|to push, to squeeze
die Geheule , -n|the bawling, the howling, the wailing
entrollen|to unfurl, to unroll
im Nu|in a heartbeat, in a flash (idiom) (i~ N~)
schlängeln|to wiggle, to meander
schwören|to vow, to swear
leise|quiet, faint
zischend|hissing
der Tierpfleger , -|the zookeeper
unter Schock stehen|to be a state of shock (u~ S~ s~)
brühen|to brew
sich überschlagen|to go head over heels, to fall over oneself, to come thick and fast (idiom)
schnattern|to chatter (schn~)
soweit|as far as
spielerisch|playful, playfully
die Ferse , -n|the heel (F~)
schlenzen|to chip, to flick, to curl, to scoop (sports)
abbeißen|to bite off
totquetschen|to crush to death
am schlimmsten|worst (a~ s~)
beruhigt|calmed, soothed, reassured
Nicht wahr?|Isn't that so? Didn't you? (idiom) (N~ w~)
warten|to wait
endgültig|final, ultimate
vorknöpfen|to have a good talking to, to take to task (idiom)
hervorbringen|to yield, to produce, to bring forth
gerade noch|barely, only just (g~ n~)
heraus|out, forth
würgen|to choke, to gag, to suffocate
zusammensacken|to slump, to crumple
schleunigst|immediately (sc~)
die Uhr , -en|the clock
Es war so weit.|The time has come. (idiom) (E~ w~ s~ w~)
elend|miserable (e~)
anstrengen|to strain, to exert
tauchen|to dive, to plunge
blendend|dazzling, blinding
brennend|blazing, burning
übrigens|by the way, incidentally
sich verneigen|to bow (s~ v~, *n*)
der Zylinder , -|(1) the cylinder (2) the tophat
schubsen|to nudge, to shove (s~)
glatzköpfig|bald (g~)
weitergehen|to continue, to progress, to go on (w~)
verschwinden|to disappear, to vanish
genauer|in greater detail, more precisely
zerbrochen|shattered, broken
in die Quere kommen|to get in the way (idiom) (i~ d~ Q~ k~)
brasilianisch|brazilian
bisher|until now, up to this point
längste|longest
einbringen|to yield, to bring, to earn, to contribute
zertrümmern|to smash into pieces
die Krücke , -n|the crutch (for walking)
radeln|to cycle, to ride a bike
Tag für Tag|day after day (idiom) (T~ f~ T~)
heimsuchen|to haunt, to distress, to trouble
die allesamt|all of whom (d~ a~)
der Anführer , -|the leader (A~)
ausgesprochen|decidedly, markedly, pronounced
das Vergnügen , -|the enjoyment, the pleasure
anschließen|to connect, to affiliate, to bond (a~)
möglichst viel|as much as possible
baldig|imminent, speedy
der Hoffnungsschlimmer , -|the glimmer of hope
dorthin|there (not da)
dagegen|(1) against it/that (2) in contrast, against this, however
die Gesamtschule , -n|the comprehensive school
eröffnen|to establish, to introduce, to open
hochkommen|to surface, to come up (h~)
fürchterlich|dreadful, terrible, appalling (fü~)
davon|from it, of it
sich einen Reim auf machen|to make sense of (idiom) (s~ e~ R~ a~ m~)
der Reim , -e|the rhyme
übel|sick, nauseous
stolpern|to stumble, to trip
begeistert|keen, excited, enthusiastic
reichen|(1) to hand, to pass, to reach (2) to suffice, to be enough
aufbewahren|to store, to keep, to preserve, to retain (a~, *wa*)
stolzieren|to strut, to swagger
kastanienbraun|maroon (k~)
der Frack , -"e|the tailcoat
die Kreissäge , -n|(1) the buzzsaw (2) the bowler hat
knorrig|gnarled, snaggy, knobbly
der Stock , -"e|(1) the cane, the staff (2) the stick (3) the floor
der Hieb , -e|the blow, the whack, the chop (H~)
versetzen|(1) to relocate, to transfer (2) to pawn (3) to deal (a blow)
gegenseitig|mutual, mutually, each other
gelten|to be valid, to apply, to pertain
das galt als|that was considered as (d~ g~ a~)
mustern|to examine, to scrutinize, to pattern (m~)
stolzeste|proudest
die Träne , -n|the tear, the teardrop
erwachsen|mature, grown-up (e~)
womöglich|possibly, maybe (w~)
anknacksen|to crack (bone, rib, etc)
laut loslachen|to laugh out loud (l~ l~)
der Gestank , -|the stench, the stink
lauter|(1) louder (2) pure, sheer (3) nothing but
entgegenschlagen|to confront somebody, to meet (ent~)
die Emailwanne , -n|the enamel tub
die Spüle , -n|the sink (S~, short form)
näher|nearer, closer
um ... zu ...|in order to ...
so ... wie ...|as ... as ...
der Lumpen , -|the rag (L~)
kneifen|(1) to pinch (2) to back out, to wuss out
Stell dich nicht so dumm an!|Don't be silly! (idiom) (S~ d~ n~ s~ d~ a~)
färben|to dye, to colour
bezweifeln|to doubt, to disbelieve, to suspect (b~)
ernsthaft|seriously
widersprechen|to object, to disagree (w~)
der Fetzen , -|the shred, the scrap, the rag (F~)
die Haut , -"e|the skin
zuhalten|to keep shut
der Briefschlitz , -e|the letter slot (of a door etc)
die Klappe , -n|the flap, the hatch
quietschen|to squeak, to creak (q~)
klatschen|(1) to clap, to smack, to crash (2) to gossip (kl~)
die Matte , -n|the mat
sollen|should, to be supposed to, to be expected to
der Knuff , -"e|the nudge, the poke (K~)
ausweichen|to dodge, to evade, to avoid (au~)
dreierlei|three different, three kinds of
enthalten|to contain, to hold (e~)
die Bücherei , -en|the library (Bü~)
anmelden|to register, to certify, to enroll
unhöflich|rude, impolite
die Aufforderung , -en|the invitation, the prompt, the request (A~)
erhalten|to obtain, to receive (e~)
ausgeschlossen|(1) impossible (2) expelled, barred (a~)
gelblich|yellowish
das Pergament , -e|the parchment
die Tinte , -n|the ink
die Briefmarke , -n|the stamp (for post)
purpurn|crimson, purplish
das Siegel , -|the seal, the sigil
das Wachs , -|the wax
das Wappen , -|the crest, the emblem
einprägen|to impress, to ingrave, to imprint on
der Adler , -|the eagle
der Dachs , -e|the badger
umschlossen|surrounded, enclosed (ums~)
der Scherz , -e|the joke, the jest, the hoax, the banter (S~)
unverwandt|(1) unrelated (2) steadfast, unwavering
auf gerichtet|directed at (a~ g~)
der or die Abscheu , -|the revulsion, the digust (two genders)
überfliegen|to scan, to skim, to fly over
faul|(1) lazy, idle (2) faul, rotten
entfalten|to unfold (e~)
bestand|existed
das Blatt , -"er|(1) the leaf (2) the sheet of paper, the page
wegschnappen|to snatch away, to take
höhnen|to sneer (h~)
schütteln|to shake (s~)
gefaltet|folded, creased, pleaded
auseinander|apart, asunder
wechseln|to change (by substitution), to switch, to vary
gräulich|greyish, dreadful, ghoulish
der Schleim , -e|the mucus, the pflegm, the slime
der Hafer , -|the oat
keuchend|panting, wheezing, gasping
in Ohnmacht fallen|to faint (i~ O~ f~)
würgend|choking, retching
das Geräusch , -e|the noise, the sound (G~)
anstarren|to stare at, to gaze at
einander|each other, one another
gewohnt|(1) accustomed, used to (2) usual, familiar
ignoriert|ignored
schmerzhaft|painful
krächzen|to croak, to caw (k~)
stopfen|to stuff, to cram
sich nicht vom Fleck rühren|to not budge (idiom) (s~ n~ v~ F~ r~)
verlangen|to demand, to require (v~)
brüllen|to yell, to roar (b~)
das Genick , -e|the neck, the scruff (G~)
liefern|to deliver (l~)
erbittert|fierce, intense
stumm|mute, voiceless, dumb, silent
lauschen|to eavesdrop, to listen
der Bauch , -"e|the belly, the stomach (B~)
das Ohr , -en|the ear
herabhängen|to droop, to dangle (h~)
der Spalt , -e|the gap, the slit, the crack (S~)
anschauen|to examine, to view (a~)
auf und ab|back and forth (a~ u~ a~)
schreiten|to stride, to walk with long steps (sc~)
so tun, als ob|to pretend (s~ t~ a~ o~)
ausmerzen|to eradicate, to eliminate
aufnehmen|(1) to incorporate, to accept (in a group), to admit (2) to record
versehentlich|inadvertently, accidentally
anbinden|to tether, to tie
kurz angebunden|tersely, brusquely (k~ a~)
verbrennen|to incinerate, to burn
das Versehen , -|the oversight, the mistake
die Decke , -n|(1) the blanket (2) the ceiling (3) the covering
ein paar Mal|a couple of times (e~ p~ M~)
Luft holen|to take breath, to breathe (L~ h~)
schmerzhaft wirkend|painful looking (s~ w~)
nachdenken|to contemplate, to think about
ziehen|to pull, to drag, to move
kreisen lassen|to go in circles, to go round (idiom) (k~ l~)
functionierend|working, functioning
die Sendung , -en|the program, the broadcast
absetzen|to drop, to degrade, to remove, to discontinue
rammen|to ram
das Luftgewehr , -e|the airgun
durchgebogen|sagged, bent-through
der Lauf , -"e|(1) the gun barrel (2) the run (3) the motion, the flow
das Regal , -|the rack, the shelf
niederlassen|to lower, to let down
anrühren|(1) to touch (2) to blend, to mix (a~)
anbrüllen|to yell at, to roar at
seufzen|to sigh
hier oben|up here (h~ o~)
schweigsam|taciturn (s~)
absichtlich|deliberately, intentionally
übergeben|to surrender (something), to deliver, to hand over
das Gewächshaus , -"er|the greenhouse (Ge~)
die Bitterkeit , -en|the bitterness, the acrimony
unablässig|relentless, incessant (unab~)
aufstehen|to rise, to stand up, to get up
mal auf, mal ab|sometimes here, sometimes there (idiom) (m~ a~ m~ a~)
hierhin und dorthin|here and there (h~ u~ d~)
ersticken|to choke, to smother, to suffocate
der Schrei , -e|the shout, the yell
ringen|to wrestle, to grapple (r~)
entwinden|to wrench from, to pry from (e~, *wi*)
das Gerangel , -|the scramble, the skirmish, the tussle (Ger~)
jeder|every, everyone, every man
einstecken müssen|to be on the receiving end of (e~ m~)
aufrichten|to upend, to return to an upright position
nach Luft ringend|gasping for breath (n~ L~ r~)
japsen|to pant, to gasp (j~)
bedeuten|to mean, to matter, to imply
sorgen|to worry, to care
klappen|(1) to work out, to function (2) to fold (3) to click (4) to clap
repariert|repaired
zum Verstummen bringen|to silence, to still (z~ V~ b~)
hinunter|down, under, to the bottom (hi~)
der Postbote , -n|the postman
pochend|throbbing, thumping, beating
matschig|muddy, mushy, squishy (m~)
lebendig|alive, lively
der Schlafsack , -"e|the sleeping bag
hindern|to hinder, to prevent
umsetzen|to implement (u~)
das Vorhaben , -|the proposition, the plan, the intention, the scheme
niederschlagen|to quell, to defeat (a riot, battle, etc)
einwerfen|to interject, to insert, to throw in (letter etc)
der Schoß , -"e|the lap
beschriftet|labelled
zerreißen|to tear, to rip up
zunageln|to nail down, to board up
schieben|to shove, to push, to thrust (s~)
der Rahmen , -|the frame
der Bindfaden , -"|the thread, the cord, the string (B~)
im Erdgeschoss|downstairs, on the ground floor
die Leiste , -n|(1) the groin (2) the ledge, the bar, the bracket
die Hintertür , -en|the backdoor
außer Kontrolle geraten|to get out of control (a~ K~ g~)
zusammenrollen|to roll up, to furl
im Innern|inside (i~ I~)
verdattert|befuddled
die Molkerei , -en|the dairy
auftreiben|to find, to search for (a~)
schnitzeln|to cut into shreds (s~, *zeln)
der Mixer , -|the blender, the mixer
wer zum Teufel|who the hell (lit: who the devil) (w~ z~ T~)
erschöpft|exhausted, weary (e~)
gemahnen|to remind (somebody of something)
bestreichen|to coat, to spread (food) (b~)
verflucht|bloody, damn, cursed
pfeifen|to whistle
sausen|to speed, to dash, to move rapidly
herunter|down, downward (he~)
der Hinterkopf , -"e|the back of the head
die Kugel , -n|(1) the sphere, the orb (2) the scoop of ice cream (3) the bullet
die Deckung , -en|the cover, the protection, the backing
fangen|to catch, to capture (f~)
die Hüfte , -n|the hip
rauschen|to rustle, to whoosh, to swoosh (rau~)
die Wand , -"e|the wall
Das reicht.|That's good enough. (idiom) (D~ r~)
das Haarbüschel , -|the tuft of hair, the clump of hair
sich einfinden|to be present, to gather for a meeting (s~ e~)
die Abreise , -n|the departure (on a journey)
die Widerrede , -n|the backtalk
das Brett , -er|(1) the board (2) the plank (3) the shelf (Br~)
vernagelt|nailed-up (v~)
der Rücksitz , -e|the backseat
wimmern|to whimper, to whine
Ich habe ihm eine geknallt|I landed him one in the face (coll.) (I~ h~ i~ e~ g~)
aufhalten|to impede, to delay, to suspend, to hinder (a~)
kehren|to sweep, to turn (change) (k~)
entgegengesetzt|opposed, opposing (e~, *zt)
abschütteln|to shake off, to dislodge
immer dann, wenn|every time (i~ d~ w~)
umkehren|to reverse, to go back (u~, *k*)
anhalten|to stop (an~)
hereinbrechen|to fall, to break (dawn/dusk)
verpassen|(1) to miss, to fail to meet (a scheduled thing) (2) to give, to inflict
der/die Außerirdische(r)|the alien, the extra-terrestrial (adj. decl.)
Halt machen|to stop (H~ m~)
feucht|moist
modrig|moldy
vorbeifahren|to drive past, to drive by
muffig|musty
die Dosentomaten|the canned tomatoes (pl)
der Empfangsschalter , -|the reception desk
das Speisezimmer , -|the dining room
schüchtern|shy, timid
der Wald , -"er|the forest, the wood
inmitten|amid, amidst, among
umgepflügt|ploughed-up
der Acker , -"|the arable field
die Hängebrücke , -n|the suspension bridge
ober|upper
das mehrstöckiges Parkhaus|the multistorey carpark (sing. only)
dumpf|dull, muffled
die Küste , -n|the coast, the shore
eingeschlossen|trapped, encased, embedded (ei~)
der Tropfen , -|the drop, the bead, the blob
der Wochentag , -e|the weekday
elfte|eleventh
sich verlassen|relied (s~ v~)
um die Mittagszeit|around noon, around midday
der Kleiderbügel , -|the coathanger
in der Ferne|in the distance
der Felsen , -|the rock
thronen|to be enthroned, to sit enthroned
schäbig|shabby, sordid (s~)
schadenfroh|mischievous, maliciously gleeful (sc~)
in die Hände klatschen|to clap one's hands (i~ d~ H~ k~)
zahnlos|toothless
humpeln|to limp, to hobble (hu~)
verschmitzt|mischievous, devilish (v~)
das Ruderboot , -e|the rowboat, the skiff
die Ration , -en|the ration
besorgen|to get, to obtain, to procure (be~)
eisig|icy, freezing
die Gischt|the seaspray, the surf (sing. only)
frostig|frosty, chilly
peitschen|to whip, to flog (p~)
schlittern|to slither
heruntergekommen|sordid, run-down, delapidated, decayed (h~)
der Seetang , -e|the seaweed
die Ritze , -n|the crack, the narrow gap (R~)
die Feuerstelle , -n|the fireplace
sich als etwas herausstellen|to turn out to be something (s~ a~ e~ h~)
die Schachtel , -n|the box, the packet, the carton (matchbox etc)
der Rauch , -|the smoke, the fume
zusammenschrumpfen|to shrivel, to swindle away
ausnahmsweise mal|just for once, once for a change (a~ m~)
bester Laune|in very good spirits (idiom) (b~ L~)
Post zustellen|to deliver mail (P~ z~)
im Stillen|inwardly, privately
aufmuntern|to cheer up, to encourage, to hearten
versprochen|promised
herum|around, about (h~)
in Fahrt kommen|to get going, to build momentum (idiom) (i~ F~ k~)
spritzen|to splash, to splatter, to squirt (s~)
rütteln|to shake, to jiggle (r~)
der Aal , -e|the eel
riechend nach|smelling of (r~ n~)
mottenzerfressen|moth-eaten
zerlumpt|ragged, tattered
weich|soft (w~)
zerrissen|torn, ripped
sich zusammenkauern|to curl up into a ball (s~ z~)
bibbern|to jitter (b~)
bequem|comfortable (b~, *q*)
der Magen , -|the stomach (M~)
röhren|to roar (like an engine) (r~)
in untergehen|to be drowned out (by a sound) (i~ u~)
das Handgelenk , -e|the wrist
baumeln|to dangle (b~)
ticken|to tick (clock)
knacken|to crack (snap, or in breaking codes etc), to break open
vollstopfen|to cram full
stibitzen|to swipe, to pinch (s~) (coll.)
auf die eine oder andere Weise|one way or another (a~ d~ e~ o~ a~ W~)
malmen|to grind loudly (like teeth) (m~)
stürzen|to plunge, to fall from a height, to topple (s~)
erzittern|to tremble, to shudder (suddenly and briefly)
kerzengerade|bolt-upright
aus dem Schlaf schrecken|to startle out of deep sleep (a~ d~ S~ s~)
die Kanone , -n|the gun, the cannon
die Wucht , -en|the force, the momentum (W~)
glattweg|simply, bluntly, point-blank (g~)
die Angel , -n|(1) the hinge (of a door or window) (2) the fishing rod
der Knall , -e|the bang, the crack (kn~)
die Türöffnung , -en|the doorway (T~)
der Riese , -n|the giant
gänzlich|entirely, utterly, completely (g~)
zottig|shaggy, ragged (z~)
die Mähne , -n|the mane
schimmern|to shimmer, to glint
sich bücken|to stoop, to bend down (s~ b~)
nachlassen|to cease, to abate, to fade, to diminish (n~)
vertragen|to stand, to tolerate (v~)
versteinert|(1) petrified (2) fossilized (v~)
Beweg dich!|Get moving! Move your ass! (idiom) (B~ d~)
der Klops , -"e|the meatball (K~)
quieken|to squeak, to squeal (q~)
hinauf|up, upwards (hi~)
grimmig|grim
das Fältchen , -|the wrinkle, the crow's feet
rasselnd|rattling (ras~)
auf der Stelle|straightaway, right away, instantly (idiom) (a~ d~ S~)
der Hausfriedensbruch , -"e|the trespass, the home invasion
Halt den Mund!|Shut up! Hold your mouth! (idiom) (H~ d~ M~)
die Pflaume , -n|(1) the plum (2) the weakling, the coward
die Lehne , -n|the armrest, the backrest
der Knoten , -|the knot (*t*)
abermals|again, once again (a~)
getreten|troden on, steppen on
den Rücken zukehren|to turn one's back to (idiom) (d~ R~ z~)
zwischendurch|in the meantime, now and then (z~)
eingedellt|dented
klebrig|sticky
zum Vorschein kommen|to appear, to emerge, to come to light (idiom) (z~ V~ k~)
der Zuckerguss , -"e|the icing (on a cake)
der Hüter , -|(1) the guardian, the keeper (2) the herdsman
die Ländereien|the landholding, the estates (plural)
prasseln|to patter (rain), to crackle
erfüllen|(1) to fulfill (2) to imbue, to suffuse
das Gewicht , -e|(1) the weight (2) the importance
einknicken|to buckle, to give way, to fold
der Kessel , -|the bowl, the kettle, the vessel, the cauldron
platt|flat (p~)
der Schürhaken , -|the poker (at a fireplace)
die Teekanne , -n|the teapot
ineinandergesteckt|one inside another
der Becher , -|the cup (without handle), the jar, the beaker
der Bernstein , -e|the amber
die Flüssigkeit , -en|the liquid
der Duft , -"e|the scent, the fragrance
brutzelnd|sizzling
der Rost , -e|(1) the rust (2) the grill, the BBQ grid
zappeln|to fidget, to flounder
mästen|to fatten, to feed up
kosten|(1) to cost (2) to taste, to savour
abwenden|to avert, to avoid
zurückweichen|(1) to flinch (2) to retreat
denen|those (de~, indirect)
kriegen|(1) to get, to receive (2) to war
Es ist zum Heulen.|It's enough to make you weep. (idiom) (E~ i~ z~ H~)
aufspringen|to bounce, to jump up
der Zorn , -|the anger, the wrath (Z~)
ausfüllen|to fill, to fill out, to occupy
die Hütte , -n|the hut, the shack
kauern|to huddle, to crouch, to squat
knurren|to growl
zu weit gehen|to go too far (z~ w~ g~)
immerhin|anyway, anyhow (i~)
abtun|to dismiss, to discount, to waive, to reject (abt~)
dröhnen|to roar, to drone, to boom (d~)
blass|pale (not 'bleich')
bestürzt|upset, confused, shocked (b~)
wiederfinden|to retrieve, to rediscover
verbieten|to prohibit, to ban, to forbid
mutiger|braver, more courageous
zusammenbrechen|to collapse, to break down (z~, *br*)
die Silbe , -n|the syllable
die Entrüstung , -en|the outrage, the indignation (En~)
vorenthalten|to withhold, to deny, to refuse
nach Luft schnappen|to gasp for breath (n~ L~ s~)
der Zauberer , -|the wizard
herrschen|to rule, to govern, to reign (h~)
die Pfeife , -n|(1) the whistle (2) the pipe
das Ächzen , -|the groan, the creak (Ä~)
einsinken|to subside, to sink in
verdammt|damn, darn (adj.)
noch dazu|.. at that, to boot, also
die Schrift , -en|the font, the typeface, the handwriting
die Hexerei , -en|the sorcery, the witchcraft
die Zauberei , -en|the wizardry
der Schulleiter , -|the headmaster
der Orden , -|the order, the congregation
erster Klasse|first-class
das hohes Tier|the bigwig, the big shot (coll.) (d~ h~ T~)
die Vereinigung , -en|the association, the union
Sehr geehrter Herr|Dear Sir (in a letter)
benötigen|to require, to need (be~)
der Ausrüstungsgegenstand , -"e|the piece of equipment (A~, *nd)
spätestens|at the latest (s~)
Mit freundlichen Grüßen|Yours sincerely (M~ f~ G~)
stellvertretend|deputy (adj.)
stammeln|to stammer (sta~)
explodieren|to explode
heißen|(1) to be called (2) to mean, to signify
galoppieren|to gallop
der Brauereigaul , -"e|the brewery horse
umhauen|to knock down, to blow away, to overwealm
zerzaust|unkempt, ruffled (for hair)
der Federkiel , -e|the quill
kritzeln|to doodle, to scribble
auf dem Kopf stehen|to be upside down (idiom) (a~ d~ K~ s~)
überreichen|to present, to bestow on, to hand over (ü~)
mitnehmen|to take along, to pick up, to give a ride to
wohlauf sein|doing well, to be fit and well (w~ s~)
der Schnabel , -"|the beak, the bill (of a duck etc.)
schleudern|to hurl, to fling, to toss (s~)
aschfahl|ashen-faced
fahl|pallid, sallow (f~)
grunzen|to grunt
der Magier , -|the magician
das Pech , -e|(1) the misfortune, the bad luck (2) the pitch, the tar
der Blödsinn , -|the nonsense, the rubbish (B~)
aufschreien|to yell, to scream out, to exclaim
vermaledeit|damned, blasted, confounded
der Froschlaich , -e|the frogspawn
verwandeln|to transform
die Missgeburt , -en|the monstrosity, the abortion, the freak of nature
innehalten|to pause, to hold, to stop for a second (i~)
erneut|anew, once again, newly
schimpfen|to rant, to badmouth, to scold (s~)
loswerden|to shed, to get rid of, to dump (l~)
bleich|pale (not 'blass')
sobald|as soon as, once
sich verdrücken|to make oneself scarce (s~ v~)
ums Leben kommen|to die (u~ L~ k~)
die Schande , -n|the shame, the disgrace (S~, *d*)
der Skandal , -e|the scandal, the outrage
drängend|urging, pressing, thrusting
erwischen|to catch, to get, to nab, to get hold of (e~)
finster|(1) sinister (2) dark (f~)
das Geheimnis , -se|the secret, the mystery
der Wasserspeier , -|the gargoyle, the waterspout
erschauern|to shiver, to tremble (e~)
der Anhänger , -|(1) the trailer (2) the supporter, the disciple, the follower
verschaffen|to provide, to make available (v~, *sc*)
sich anfreunden|to become friends (s~ a~)
sich wehren|to fight back, to defend (s~ w~)
der Schulsprecher , -|the headboy
gerade mal|no more than (g~ m~)
sich die Nase schnäuzen|to blow one's nose (s~ d~ N~ s~)
das Nebelhorn , -"er|the foghorn
das Töten , -|the killing
der Fluch , -"e|the curse, the bane
berühren|to touch, to move (emotionally), to affect (b~)
beschließen|to resolve, to determine, to conclude (b~, *ß*)
abspielen|to play back, to act out
deutlich|distinct, clear
höhnisch|derisive, mocking, snide
das Lachen , -|the laugh, the laughter (L~)
betrachten|to consider, to look at carefully, to regard, to view
zerstört|destroyed
der Befehl , -e|the order, the command
aufschrecken|to startle (a~)
wiedergewinnen|to recoup, to regain, to recover
die Fäuste ballen|to clench one's fists (d~ F~ b~)
schnauzen|to snap, to rant
vermutlich|presumably, probably (v~)
mag|may (possibly)
die Ohrfeige , -n|the slap to the face, the bitchslap
kurieren|to cure (k~)
was ... angeht|with respect to ... , as regards ...
besser dran|better off
das Pack , -e|the pack, the mob, the vermin
einlassen|to let in, to admit
ein Ende nehmen|to come to an end (e~ E~ n~)
zerfleddert|tattered
der Schirm , -e|(1) the umbrella (2) the screen (3) the cap, the shield
das Schwert , -er|the sword
entgegen|against (e~)
bärtig|bearded
aufspießen|to impale, to skewer
Nun, da ...|Now that ...
verstummen|to hush, to become silent (v~)
diesmal|this time
Es liegt mir auf der Zunge.|It's on the tip of my tongue. (idiom) (E~ l~ m~ a~ d~ Z~)
der Erdboden , -"|the soil, the ground, the earth
vom Erdboden verschwinden|to disappear off the face of the Earth (idiom) (v~ E~ v~)
verschlucken|to swallow up, to absorb
der Stuss , -|the baloney, the nonsense (S~)
die Trance , -n|the trance
erwachen|to awake, to become awake (e~)
vorhaben|to intend, to plan (v~)
weitermachen|to proceed, to continue (w~)
den Garaus machen|to kill off, to cook one's goose (idiom) (d~ G~ m~)
die Hochachtung , -en|the deference, the esteem
die Wärme , -n|the warmth
der Irrtum , -"er|the fallacy, the error (I~)
gelitten|suffered (leiden past-p)
schikanieren|to bully, to persecute (s~)
einschließen|(1) to involve, to include (2) to trap, to box
warzig|warty
die Kröte , -n|the toad
einst|once, at one time in the past
besiegen|to vanquish, to defeat (b~)
herumkicken|to kick about (like a football)
die Flucht , -en|the escape, the getaway (Fl~)
partout|absolutely (p~)
die Rache , -n|the revenge
loslassen|to release, to let go
geradezu|downright, virtually (g~)
anstrahlen|to beam at, to smile, to spotlight
abwarten|to bide, to wait and see (a~)
kampflos|peacefully, without a fight
aufgeben|to give up, to surrender, to relinquish
der Zauberstab , -"e|the magic wand
die Fibel , -n|(1) the brooch (2) the handbook, the primer
der Zauberspruch , -"e|the incantation, the magic spell
vormerken|to earmark, to reserve
wiedererkennen|to recognise (w~)
seinesgleichen|his equals, his peers
hirnrissig|nutty, wacky, crazy (h~)
beibringen|to teach (b~)
poltern|to clatter, to crash about (p~)
beleidigen|to insult (bel~)
die Gegenwart , -en|(1) the present (time) (2) the presence
die Spitze , -n|the top, the tip, the apex, the peak
die Feuerwerkskörper|the fireworks, the firecrackers (plural)
schrill|shrill, strident, jarring, piercing
das Kreischen , -|the screech (K~)
aufführen|to perform, to act (e.g. in a play)
der Hintern , -|the bum, the butt
heulend|howling
geringelt|curly, hooped, ringed (g~)
das Schwänzchen , -|the little tail
purzeln|to fall, to tumble, to roll out (p~)
toben|to rage, to rampage, to clamour
angsterfüllt|frightened, full of fear (a~)
die Beherrschung , -en|(1) the mastery, the control (2) the composure (emotions)
reuevoll|rueful, ruefully
buschelig|tufty
die Augenbraue , -n|the eyebrow
folgen|(1) to follow, to track, to persue (2) to ensue
zaubern|to conjure, to perform magic (z~)
rauswerfen|to throw out, to kick out (r~)
der Wildhüter , -|the gamekeeper
dabehalten|to keep there
erledigen|to settle, to sort out, to do, to handle (er~)
abnehmen|(1) to decrease (2) to decline (3) to remove, to take off
pennen|to sleep (p~)
Mach dir nichts draus!|Take it easy! (idiom) (M~ d~ n~ d~)
die Haselmaus , -"e|the dormouse
die Gasse , -n|the alley, the alleyway
der Winkel , -|the angle (maths), the corner (W~)
tappend|toddling
das Sonnenlicht|the sunlight (no plural)
fluten|(1) to surge (a crowd) (2) to flood
die Kralle , -n|the claw, the talon (Kr~)
sich aufrappeln|to pull oneself together (s~ a~)
der Ballon , -s|the balloon
schnurstracks|hotfoot, straightaway, directly
aufreißen|to rip open, to rip up, to yank open
schweben|to hover, to float
flattern|to flutter, to flap
picken|to peck
Lass das!|Cut it out! Stop doing that! (idiom) (L~ d~)
wegscheuchen|to shoo away, to banish (w~)
hacken|to hack, to chop
zerfetzen|to mangle, to shred severely (z~, *t*)
der Lohn , -"e|the wage, the pay, the reward (L~)
die Muskete , -n|the musket
der Bindfaden , -"|the thread, the cord, the string (B~)
der Teebeutel , -|the teabag
die Münze , -n|the coin
abzählen|to count (ab~)
genüsslich|appreciative, appreciatively (g~)
das Glied , -er|the limb (body)
nachdenklich|thoughtful, pensive
der Pikser , -|the chip fork
kratzen|to scratch
Mach dir keine Gedanken darüber!|Don't worry about it! (idiom) (M~ d~ k~ G~ d~)
hinterlassen|bequeathed, left behind
der Kobold , -e|the goblin (K~)
bescheuert|dumb, bonkers, daft (be~)
vorbeischauen|to stop by, to look in on
abholen|to collect, to pick up
Na los!|Go ahead! (idiom) (N~ l~)
vorstellen|to introduce (v~)
rudern|to row (with oars)
beschleunigen|to accelerate
gespannt|(1) tense, nervous (2) keen, eager (g~)
das Verlies , -e|the dungeon (V~)
der Drache , -n|the dragon
bewachen|to guard, to stand watch (bew~)
der Nagel , -"|the nail, the spike
der/die Erwachsene(r)|the adult (adj. decl.)
schwerfallen|to be difficult for
auf dem Herzen haben|to have on one's mind (idiom) (a~ d~ H~ h~)
das Ministerium , die Ministerien|the ministry, the department
platzen|to burst, to crack, to split open (p~)
losplatzen|to burst out laughing
der Stümper , -|the bungler, the incompetent
landauf, landab|up and down the country (idiom) (l~, l~)
stupsen|to prod, to nudge, to poke (s~)
der Hafen , -"|the harbour, the port
verübeln|to resent (v~)
zeigen|to show, to exhibit, to display (z~)
die Parkuhr , -en|the parking meter
außer Atem|out of breath (a~ A~)
der Atem , -|the breath
zurechtkommen|to manage, to get by (z~)
der Schein , -e|(1) the ticket (2) the banknote (3) the certificate
glotzen|to peer, to gawk, to goggle (g~)
stricken|to knit
der Kanarienvogel , -"|the canary (bird)
der Zirkus , -se|the circus
das Zelt , -e|the tent
die Masche , -n|(1) the scam, the trick, the ploy (2) the stitch (of knitting etc) (3) the mesh
der Bogen , -"|(1) the arch (2) the arc (3) the bow (weapon) (4) the sheet (of paper)
die Garnitur , -en|(1) the set (2) the uniform (G~)
einfach|(1) easy (2) plain (3) simple, basic
der Spitzhut , -"e|the pointed hat
beachten|to take into account, to consider
das Kleidungsstück , -e|the garment, the piece of clothing
das Etikett , -en|the tag, the label (E~)
etwas mit etwas versehen|to give or equip sth. to sth. (e~ m~ e~ v~)
jeweils|respectively, each (j~)
das Exemplar , -e|the specimen, the copy, the instance (E~)
das Kraut , -"er|(1) the herb (2) the cabbage
der Zaubertrank , -"e|the magic potion
das Bräu , -e|the brew (B~)
phantastisch|fantastic
die Selbstverteidigung|the self-defense (no plural)
ferner|further, furthermore, moreover (f~)
das Zinn|the Tin (element) (no plural)
die Normgröße , -n|the standard size
das Sortiment , -e|the assortment, the range
das Fläschchen , -|the vial, the small bottle
das Teleskop , -e|the telescope (T~)
die Waage , -n|the scale, the balance
das Messing|the brass (material) (no plural)
zudem|moreover, in addition, furthermore (z~)
freigestellt|exempted
der Erstklässler , -|the first-former, the first-grader (pupil)
der Besen , -|the broom, the brush
gelangen|to get to, to arrive (g~)
sich verheddern|to get oneself entangled (s~ v~*he*)
das Drehkreuz , -e|the turnstile
lahm|lame, tame, sluggish, feeble
beleben|to invigorate, to enliven
gesäumt|seamed, hemmed, lined
führen|to lead, to guide, to conduct (f~)
der Keil , -e|the wedge
treiben|to drive, to propel, to float, to drift
der Schnellimbiss , -e|the fast food restaurant (S~)
haufenweise|galore, heaps of (h~)
der Jux , -e|the practical joke, the lark, the hoax (J~)
keinerlei ...|absolutely no ..., no ... at all
der Sinn für Humor|the sense of humour (sing. only) (d~ S~ f~ H~)
schlicht|plain, modern, simple, unpretentious
unfassbar|intangible, inconceivable (unf~ *r)
schmuddelig|grubby, grimy (s~)
der Plattenladen , -"|the record shop
eigentümlich|curious, peculiar, odd (e~)
tropfend|seeping, dipping
aufmachen|to open, to open up, to unfasten
berühmt|famous
rauchen|to smoke
der Wirt , -e|the landlord (of a pub), the host
vollkommen|utter, utterly (v~, not völlig), perfect, ideal
kahlköpfig|bald (k~) (long form)
die Walnuss , -"e|the walnut
eintreten|(1) to enter (a room) (2) to become a member (3) to occur
die Summe , -n|the sum, the total
winken|to wave, to beckon
der Klaps , -e|the pat, the light slap
mit einem Schlag|at a blow, at once (idiom) (m~ e~ S~)
mucksmäuschenstill|as quiet as a mouse
Grundgütiger!|Good gracious! (G~)
Welch eine Ehre!|What a honour! (W~ e~ E~)
ergreifen|to seize, to grasp, to take (e~)
paffen|to puff (on), to whiff (a cigar)
das Stühlerücken , -|the reshuffle (of positions) (S~)
einer nach dem anderen|one after the other (e~ n~ d~ a~)
schwindelig|dizzy (not 'schwurbelig')
erfreut|pleased, delighted (e~)
die Aufregung , -en|the excitement (A~)
sich etwas bahnen|to channel the way for something (s~ e~ b~)
nach vorne|forward, forwards (n~ v~)
wirken|(1) to appeal, to be attractive (2) to appear, to seem (3) to work, to operate
fahrig|erratic, agitated (f~)
die Ausrüstung , -en|the equipment, the gear (A~, *g)
bloß|(1) mere, merely (2) just, only (b~)
furchtbar|awful, dreadful, terrible (f~)
verängstigt|frightened, scared, anxious
der Beschlag , -"e|(1) the mist (2) the horseshoe (3) the hinge (4) the metal fitting
in Beschlag nehmen|to hog, to commander, to monopolize (idiom) (i~ B~ n~)
das Gehör , -e|(1) the hearing (2) the audition
umgeben|(1) to surround (2) surrounded (u~)
das Unkraut , -"er|the weed
der Kerl , -e|the bloke, the guy (K~)
sich freinehmen|to take time off, to have a holiday (s~ f~)
wackeln|to wibble, to wobble (wac~)
der Torbogen , -"|the archway
gepflastert|cobbled, paved
verblüffen|to stun, to flabbergast, to confound, to amaze
der Stapel , -|the pile, the stack
das Schild , -er|(1) the sign (2) the shield
die Himmelsrichtung , -en|the cardinal direction
die Auslage , -n|(1) the display (2) the expense
rundlich|rotund, chubby
die Leber , -n|the liver
die Unze , -n|the ounce
das Kaufhaus , -"er|the department store (K~)
der Steinkauz , -"e|the little owl
die Schleiereule , -n|the barn owl
das Fass , -"er|the barrel, the cask (F~)
die Fledermaus , -"e|the bat (animal)
die Milz , -en|the spleen
wackelig|shaky, wobbly
stapeln|to pile, to stack (s~)
der Globus , die Globen|the globe
anlangen|(1) to concern, to relate to (2) to arrive
ragen|to tower, to loom (high), to project, to protrude
blank|(1) sheer (2) bare, naked (3) shiny
polieren|to polish, to burnish (not 'putzen')
das Tor , -e|the gate, the goal
scharlachrot|scarlet (colour)
goldbestickt|gold-embroidered
steinern|stony
die Stufe , -n|the step, the tier, the stage (St~)
hochsteigen|to soar, to ascend (h~)
dunkelhäutig|swarthy
die Verbeugung , -en|the curtsy, the bow
eingravieren|to engrave
die Sünde , -n|the sin, the evil
die Gier|the greed (no plural) (Gi~)
etwas verdienen|to deserve something
die Pein , -en|the torment, the pain, the anguish (P~)
verlieren|to lose (v~, *lie*)
der Schatz , -"e|(1) the treasure (2) the darling, the sweetheart, etc
der Dieb , -e|the thief
harren|to abide, to wait for (literary) (h~)
der Marmor , -e|the marble
der Schemel , -|the footstool
der Foliant , -en|the tome (F~)
wogen|to surge, to billow, to wave (w~)
prüfen|to examine, to check, to consider, to test (p~)
der Edelstein , -e|the gem, the gemstone
die Lupe , -n|the magnifier, the magnifying glass (L~)
unzählig|myriad, countless (u~)
leiten|to conduct, to guide, to lead, to oversee (l~)
die Braue , -n|the brow
Moin!|Hello! (M~, Northern Germany)
entnehmen|to extract, to withdraw
irgendwo|somewhere
entleeren|to drain, to empty, to deplete (e~)
ausbreiten|to spread, to spread out
wobei|whereby (wob~)
krümelig|crumbly (k~)
das Kassenbuch , -"er|the ledger, the cashbook
verstreuen|to scatter (at random), to disperse (v~)
die Nase rümpfen|to wrinkle the nose (d~ N~ r~)
der Rubin , -e|the ruby
der Haufen , -|(1) the heap, the pile (2) the bunch of people
die Kohle , -n|the coal
in Augenschein nehmen|to examine, to inspect, to eyeball up (i~ A~ n~)
gewichtig|grave, serious (g~)
sich die Acht nehmen|to be careful , to be aware (idiom) (s~ d~ A~ n~)
veranlassen|to prompt, to induce, to arrange
streng|strict
der Gang , -"e|(1) the aisle (2) the passageway, the alley, the corridor (3) the gear, the duct
lodernd|flaming, blazing (l~)
die Fackel , -n|the torch
das Gleis , -e|the track (rail) (G~)
steil|steep
die Tiefe , -n|the depth
die Karre , -n|the cart (K~)
die Schiene , -n|the rail (S~)
das Gewirr , -e|(1) the tangle (2) the warren, the maze (of streets etc)
ratternd|rattling (rat~)
schmerzen|to ache, to hurt
der Stoß , -"e|the hit, the burst
vordringen|to advance, to press forward
unterirdisch|underground
der Stalaktit , -en|the stalactite
der Stalagmit , -en|the stalagmite
Mir ist schlecht.|I feel ill (idiom) (M~ i~ s~)
aufschließen|to unlock (a~)
der Schwall , -e|the spate, the torrent, the barrage (S~)
dringen|to penetrate, to get through (short form)
sich verziehen|to disperse (fog etc), to disappear, to make oneself scarce, to go away (s~ v~)
der Hügel , -|the hill, the mound
das Vermögen , -|(1) the fortune (2) the asset (financial)
gehören|to belong (to) (short form)
die Galeone , -n|the galleon
die Geschwindigkeit , -en|the velocity, the speed (G~)
die Kurve , -n|the curve, the bend (K~)
rasen|(1) to dash, to speed, to race (2) to rave, to rage (r~)
die Schlucht , -en|the ravine, the gorge (S~)
der Kragen , -"|the collar
schmelzen|to melt (s~)
heischen|to demand (h~)
saugen|to suck (s~)
die Falle , -n|the trap, the snare, the pitfall
begierig|eager (b~)
sagenhaft|fabulous, marvellous (s~)
der or das Juwel , -en|the jewel (two genders)
umwickelt|wrapped-around
verstauen|to stow, to store away (v~)
die Hölle , -n|the hell
haarsträubend|dreadful, appalling (haa~)
ausmachen|(1) to recognise, to make out (2) to amount to, to represent (money) (3) to turn off
bewusst|(1) aware (2) conscious
die Gelegenheit , -en|(1) the opportunity (2) the occasion (3) the instance
genehmigen|to approve, to permit (g~)
das Fuhrwerk , -e|the wagon (F~)
stämmig|stocky, sturdy (of a body) (s~)
malvenfarbe|mauve
ausstatten|to endow, to equip, to outfit (a~, *tt*)
abstecken|to pitch, to mark out, to define
die Nadel , -n|the needle
aufstellen|to deploy, to establish, to arrange, to set up
stellen|to place, to put (st~)
die Länge , -n|the length
gelangweilt|bored
schleppend|sluggish, drawn out (s~)
mitschleifen|to drag along
schmuggeln|to smuggle
auswählen|to choose, to select (.ä.)
abhauen|(1) to elope, to run off (2) to chop off (3) to scoot
die Tüte , -n|the bag (.ü.)
der Knecht , -e|the servant (K~)
die Gelände , -n|the compound, the enclosed area, the grounds (of a school etc)
sich betrinken|to get drunk (s~ b~)
des Öfteren|frequently, many a time (d~ Ö~)
etwas in Brand stecken|to set something on fire (e~ i~ B~ s~)
die Spur , -en|(1) the trace, the hint (2) the track
die Häme , -n|the malice (H~)
knapp|(1) scarce (2) concise, terse, succinct (3) close, tight
der Klang , -"e|the sound, the tone, the ring (K~)
wortkarg|taciturn (w~)
lecken|to lick
die Himbeere , -n|the raspberry
Was ist los?|What's up?
lügen|to lie (deceive)
die Muttermilch|the breast milk (M~)
einziehen|(1) to collect, to confiscate (2) to pull in (3) to retract
die Einzigen|the only ones
die Linie , -n|the line (L~)
ewig|eternal
die Gehwegplatte , -n|the flagstone, the pavement slab
die Seide , -n|the silk
verzaubern|to enchant, to mesmerize (v~)
verhexen|to jinx, to bewitch
der Akt , -e|the act, the deed
wabbeln|to wobble (wab~)
vertrocknen|to wither, to become dry, to dry up
brenzlig|dicey, hairy
umgehen|to circumvent, to go around, to bypass
abmessen|to gauge, to measure out
zusammenschiebbar|collapsible, telescopic
die Mischung , -en|the blend, the mixture
verrottet|rotted
getrocknet|dried
die Wurzel , -n|the root (W~)
das Pulver , -|the powder (neut.)
die Schnur , -en|the string, the lace, the cord, the twine
aufzeigen|to reveal, to show off
der Reißzahn , -"e|the fang (R~)
die Auswahl , -en|the range, the choice, the selection
bitten|(1) to request (2) to plead, to beg
untersuchen|to examine, to investigate (u~)
winzig|tiny
die Schöpfkelle , -n|the ladle
die Kelle , -n|the trowel, the ladle, the ping pong bat
spüren|to feel, to sense
angesagt|hip, trendy
auslachen|to laugh at
niesen|to sneeze
nützlich|useful (n~)
der Diament , -en|the diamond
aufblitzen|to flash, to flare up
der Flügel , -|(1) the wing (2) the grand piano
klingen|to sound (k~)
schroff|gruffly, rugged
allzu|all too, overly
abblättern|(1) to exfoliate (2) to flake, to peel off
der Buchstabe , -n|the letter (of the alphabet)
verblassen|to fade, to pale
das Kissen , -|the pillow
staubig|dusty
die Glocke , -n|the bell (G~)
die Ausnahme , -n|the exception
der Storch , -"e|the stork
storchbeinig|spindle-legged
fremd|foreign, strange
die Aufsicht , -en|the supervision, the oversight
länglich|oblong, elongated
kribbeln|to prickle, to tingle (like pins and needles)
der Nacken , -|the nape, the back of the neck
der Staub , -e|the dust
kitzeln|to tickle (ki~)
erschrecken|to frighten, to scare (e~)
die Düsternis , -se|the gloom, the murk (Dü~)
verlegen|embarrassed (v~)
der Zoll , -|the inch
der Zoll , -"e|the custom, the duty, the tariff
zehneinviertel|ten and a quarter
geschmeidig|smooth (ge~)
das Weidenholz , -"er|the willow (wood)
fertigen|to fashion, to craft, to produce, to finish (f~)
gruselig|creepy (g~)
hingegen|however, whereas (h~)
das Mahagoni|the mahagony (no plural)
hervorragend|outstanding, terrific, superlative (h~)
im Grunde|basically, at root (idiom)
neblig|foggy
anrichten|to cause (damage, harm, etc) (an~)
die Eibe , -n|the yew (tree)
anstellen|(1) to employ, to hire (2) to investigate (3) to carry out
die Eiche , -n|the oak (tree)
biegsam|limber, pliable
ausschließen|to exclude, to expell, to bar
scharren|to paw, to scrape the ground (s~)
hinzufügen|to add (h~, *f*)
strahlend|radiant, beaming
umklammern|to clutch, to clasp
fest|firm, solid, fixed
das Bandmaß , -e|the measuring tape
der Strich , -e|the stroke, the line, the streak, the dash (S~)
der Ellenbogen , -|the elbow (long form)
die Armbeuge , -n|(1) the crook of the arm (2) the bicep curl
der Kern , -e|(1) the heart, the core (2) the nucleus (3) the pip (4) the gist, the essence
der Phönix , -e|the phoenix
die Faser , -n|the fibre
gleichen|(1) to resemble (2) to equal
das Resultat , -e|the result (R~)
erzielen|to achieve (success), to obtain
der Abstand , -"e|the gap, the distance (A~)
von selbst|by itself, automatically (v~ s~)
zusammenschnurren|to retract (e.g. of muscles)
probieren|to try, to attempt
handlich|handy, convenient (h~)
albern|ridiculous, silly, foolish (a~)
der Ahorn , -e|the maple
die Peitsche , -n|the whip
erhoben|raised, erect (e~)
entreißen|to wrest, to snatch away from (e~)
das Ebenholz , -"er|the ebony (wood)
das Einhorn , -"er|the unicorn
achteinhalb|eight and a half
federnd|springy
worauf|whereupon
abgelegen|remote, outlying, secluded (a~)
ungewöhnlich|unusual, uncommon
die Verbindung , -en|(1) the conjunction, the connection, the link (2) the chemical compound
die Stechpalme , -n|the holly
der Strom , -"e|the current, the electricity
der Funke , -n|the spark
johlen|to yell, to howl, to hoot (j~)
einzeln|particular, individual, alone
bestimmen|to determine, to decide (b~, *t*)
leiden|(1) to suffer (2) to tolerate
menschenleer|deserted (streets etc)
beladen|(1) laden, weighed down (2) to load (b~)
der Imbiss , -e|the snack
verspeisen|to eat (v~)
kauen|to chew
wofür|for what, wherefore
liebevoll|tender, loving
damals|at that time, then
irgendwelche|any (*w*)
neundreiviertel|nine and three quarters
die Wahrheit , -en|the truth
die Hinsicht , -en|the respect, the regard (e.g. 'in this respect')
niedergeschlagen|depressed (n~)
das Glück , -e|the luck, the fortune, the happiness (G~)
andauernd|continuous, ongoing, persistent (and~)
hereinkommen|to come in, to enter
der Kalender , -|the calendar
heften|to tack
abhaken|to tally, to tick, to check off
aufmerksam|attentive
das Zeichen , -|the sign (Z~)
überschnappen|to go crazy, to snap, to go bonkers
die Mühe , -n|the effort, the toil
gestalten|to shape, to pattern, to design
erscheinen|to appear (e~)
umziehen|to relocate, to move (address etc)
vergewissern|to assure, to check, to certify (v~)
dabeihaben|to pack, to carry (d~)
der Käfig , -e|the cage
überreden|to persuade (*rr*)
der Gepäckwagen , -|the baggage trolley
das Gesicht , -er|the face
der Bahnsteig , -e|the platform (at a train station)
dazwischen|between (d~)
trocken|dry
ansprechen|to address, to talk to, to approach
der Wachmann , -"er|the guard, the security guard, the watchman
zusehends|increasingly, visibly (zus~)
ärgerlich|annoying, angry, aggravating (ä~)
mürrisch|grumpy (m~)
die Bemerkung , -en|the remark, the comment
der Zeitverschwender , -|the lollygagger, the time waster
bewahren|to preserve, to retain
die Ankunftstafel , -n|the arrivals board (at a station)
der Backstein , -e|the brick (B~)
etwas Bestimmtes|something in particular, something specific (e~ B~)
kugelrund|tubby, spherical
piepsen|to cheep, to squeak
ebenfalls|likewise
entgehen|to avoid, to escape (e~, *g*)
die Absperrung , -en|the barrier, the cordon (A~)
schwärmen|(1) to fancy (2) to swarm (3) to daydream
die Truppe , -n|the troop, the outfit (a team etc)
verzogen|(1) warped, distorted (2) spoiled (a child etc) (3) removed, moved away
dran sein|to be next (d~ s~)
der Zwilling , -e|the twin
zügig|swift, speedy (z~)
spurlos|without a trace
schlaksig|lanky
die Sommersprosse , -n|the freckle
stabil|stable, sturdy, solid
der Eindruck , -e|the impression, the impact
rempeln|to barge, to shove (r~)
in der Patsche sitzen|to be in trouble, to be in a jam, to be in hot water (idiom) (i~ d~ P~ s~)
der Aufprall , -e|the impact, the collision
die Dampflok , -s|the steam train (short form)
das Schmiedeeisen , -|the wrought iron
der Dampf , -"e|(1) the steam (2) the vapour
das Geschnatter , -|the chatter
der/die Wartende(r)|the waiter (person who waits for someone) (adj. decl.)
besetzen|to occupy, to take control (b~)
der Waggon , -s|the railway carriage
streiten|to argue, to quarrel (s~)
der Auflauf , -"e|(1) the casserole (2) the crowd
die Rastalocke , -n|the dreadlock
die Umstehenden|the bystanders (plural) (U~)
das Abteil , -e|the compartment (of a train etc)
wuchten|to heave, to lift with difficulty, to drag (w~)
hochhieven|to heft
wehtum|to hurt, to be in pain
schweißnass|sweaty, wet with sweat (s~)
der Chor , -"e|the choir, the chorus
allerdings|indeed, however, though (a~)
verdeckt|(1) covert (2) concealed, hidden
das Taschentuch , -"er|the handkerchief
putzen|to clean, to polish (p~)
wogend|billowing
das Abzeichen , -|the badge, the insignia
ganz vorn|at the very front
der Vertrauensschüler , -|the prefect (school) (V~)
nebenbei|incidentally, besides
die Wange , -n|the cheek (W~)
sich verabschieden|to say goodbye, to farewell (s~ v~)
sich benehmen|to behave (s~ b~)
Rate mal!|Guess what!
höflich|polite
danach|afterwards, after it
fehlen|(1) to lack (2) to miss, to be absent
Reg dich ab!|Chill! Calm your tits! (idiom)
gellen|to yell, to shrill, to ring out (g~)
weinen|to weep, to cry
die Brille , -n|(1) the toilet seat (2) the pair of glasses (B~)
zum Abschied winken|to wave goodbye (z~ A~ w~)
vorbeiziehen|to roll by, to roll past (clouds, landscape on a train, etc)
zurücklassen|to leave behind
allemal|always, certainly, every time
die Mitte , -n|the middle
die Tarantel , -n|the tarantula (spider)
hervorsprudeln|to spout forth
überall|everywhere (ü~)
sich verdüstern|to darken (mood) (s~ v~)
die Erwartung , -en|the expectation
die Note , -n|(1) the grade (school) (2) the note (music)
außerdem|moreover, besides (a~)
schlimm|sad, bad (s~)
leisten|to achieve, to accomplish (l~)
beeindrucken|to impress (b~)
wetten|to bet, to wager
sich etwas von der Seele reden|to get off one's chest, to talk away one's problems (idiom) (s~ e~ v~ d~ S~ r~)
seit kurzem|as of late, since recently (s~ k~)
bereiten|to cause (grief, pain, etc) (be~)
gelassen|(1) calm, placid, serene (2) left
die Wiese , -n|the meadow, the pasture
das Schaf , -e|the sheep
das Feld , -er|the field
das Geklirre , -|the clattering
das Geklapper , -|the clatter
das Grübchen , -|the dimple
die Stulle , -n|the slice of bread and butter
nuscheln|to mumble (n~)
der Schokoriegel , -|the chocolate bar
der or das Kaugummi , -s|the bubble gum (K~) (two genders)
die Pastete , -n|the pie (savoury) (P~)
der Kürbis , -se|the pumpkin
der or das Lakritz|the liquorice (two genders) (no plural)
von allem etwas|something of everything (v~ a~ e~)
verhungern|to starve (to death)
der Bissen , -|the bite, the mouthful, the morsel
klobig|clunky
das belegtes Brot|the open sandwich (no plural)
futtern|to chow down, to feast, to scoff
das Sammeln , -|the collecting, the gathering
wickeln|to wrap, to roll, to wind
tragen|to wear, to carry
wehend|wafting, blowing
Sag bloß!|No shit! You don't say! (idiom) (S~ b~)
gegenwärtig|current, present
in der jüngeren Geschichte|in recent history (i~ d~ j~ G~)
der Ruhm , -|the fame, the glory (R~)
beruhen|to consist, to base on
der Sieg , -e|the victory
die Entdeckung , -en|the discovery
die Anwendung , -en|the application, the utilization
die Alchemie , -n|the alchemy
verfassen|to write, to compose (a book, article etc) (v~)
die Vorliebe , -n|the preference, the bias (V~, *li*)
die Kammermusik , -en|the chamber music
rumhängen|to loiter (r~)
Bedien dich!|Help yourself! (B~ d~)
merklich|(1) sensible (2) markedly, noticeably, appreciably
abwandern|to migrate
der Spinat , -|the spinach
die Kuttel , -n|the tripe
der Popel , -|the bogey, the snot
der Rosenkohl|the brussel sprouts (no plural)
die Kokosnuss , -"e|the coconut
kühn|bold, audacious (k~)
knabbern|to nibble
anfassen|to touch, to grab (a~)
die Landschaft , -en|the countryside, the landscape
zunehmend|increasingly
verschlingen|(1) to devour (2) to engulf
verweint|tearstained (v~)
aufregen|to upset, to agitate (au~)
die Krätze , -n|the itch (K~)
stöbern|to browse, to rummage (s~)
aufschieben|to procrastinate (a~)
gebieterisch|commanding, authoritative (g~)
üppig|lush, sumptuous
der Haarschopf , -"e|the shock of hair
der or das Eidotter , -|the egg yolk (two genders)
der Sonnenschein|the sunshine
wedeln|to wag, to fan (w~)
auswendig gelernt|learnt by heart (a~ g~)
sprudeln|(1) to bubble, to fizz (2) to spit out words
atemberaubend|stunning, breathtaking
ablesen|to read off, to measure, to gather (a~)
murmeln|to mutter
die Lektüre , -n|the reading, the reading matter
der Hintergrund , -"e|the background
der Aufstieg , -e|(1) the ascent (2) the promotion
der Niedergang , -"e|the demise, the downfall, the downturn
die Chronik , -en|the chronicle
Nicht zu fassen!|Unbelievable! (idiom) (N~ z~ f~)
schwurbelig|dizzy, confused (not 'schwindelig')
das Schlepptau , -e|the towrope
im Schlepptau|in tow (coll.)
die Hauptsache , -n|the main point, the essential
woanders|elsewhere, somewhere else (w~)
der Blindgänger , -|the dud (B~)
gefangen|caught, trapped (gef~)
trübselig|(1) misty (2) miserable, gloomy
das Schnurrhaar , -e|the whisker (animal) (S~)
ablenken|to distract
erforschen|to research (e~)
ausrauben|to rob (a~)
Rumänien|Romania
die Schlagzeile , -n|the headline
eindringen|to invade, to infiltrate
dahinterstecken|to be behind it (idiom)
die Neuigkeit , -en|the novelty, the piece of news
gestehen|to confess, to admit (g~)
beschreiben|to describe
raffiniert|subtle, refined, nifty
einführen|(1) to launch (a product etc.), to introduce (2) to bring in
fies|nasty, mean (f~)
der Leibwächter , -|the bodyguard (m)
der Husten , -|the cough
verdruckst|inhibited, shy, timid (v~, *dr*)
das Kichern , -|the giggle, the chuckle (K~)
die Sorte , -n|the ilk, the sort
behilflich|helpful, instrumental, collaborative (b~)
keine Anstalten machen|to make no move (idiom) (k~ A~ m~)
der Hauch , -e|(1) the whiff (2) the tinge (3) the smell (4) the hint
sich vorsehen|to be careful, to watch oneself (s~ v~)
das Gesindel , -|the riffraff, the rabble, the vermin
abfärben|to stain, to bleed colour (a~)
der Zeigefinger , -|the index finger
versenken|(1) to scuttle (ship) (2) to plunge
weichen|to yield, to give way, to retreat (w~)
jaulen|to yelp, to howl, to whine (j~)
lauern|to lurk (l~)
die Begegnung , -en|the encounter
die Ausrede , -n|the excuse
kindisch|immature, childish
hochnäsig|conceited, haughty
der Dreck , -|the muck, the filth, the dirt (D~)
hallen|to echo, to resound (h~)
der Rest , -e|the remainder, the remains
der Stillstand , -"e|(1) the standstill (2) the stalemate, the gridlock
vertraut|familiar
vermuten|to suppose, to presume
der Augenblick , -e|the instant, the moment
das Ufer , -|the bank (of a river etc), the shore
drüben|beyond, over there (d~)
die Zinne , -n|the battlement
der Turm , -"e|the tower
die Flotte , -n|the fleet
dümpeln|to bob up and down (of a boat etc)
gleichzeitig|simultaneous, simultaneously (g~)
die Bewegung , -en|the movement, the motion
nähern|to near
sich ducken|to duck, to crouch (s~ d~)
der Vorhang , -"e|the curtain
der or das Efeu , -|the ivy (two genders)
auftreten|to occur, to appear, to emerge (a~)
anscheinend|apparently
unterhalb|below, beneath, underneath (*h*)
He!|Hey!
selig|(1) blessed (2) overjoyed (3) deceased
stiefeln|to stride, to march (st~)
die Treppe , -n|the stairs (T~)
der Schatten , -|the shadow
versammeln|to gather (people), to assemble
sogleich|readily, immediately
die Kirsche , -n|the cherry
Mit ihr ist nicht gut Kirsche essen.|It's best not to mess with her (idiom) (M~ i~ i~ n~ g~ K~ e~)
das Stockwerk , -e|the storey (S~, *k)
fliesen|to tile
die Kammer , -n|the chamber
beieinander|together, side by side (b~)
das Bankett , -e|the banquet
einnehmen|(1) to occupy (space) (2) to take (food or medicine) (3) to capture (a town)
die Zeremonie , -n|the ceremony
gleichsam|quasi, so to speak (g~)
gemeinsam|mutual, common, joint, together
der Unterricht , -e|the lesson, the class (U~)
der Schlafsaal , die Schlafsäle|the dorm
der Gemeinschaftsraum , -"e|the common room
ehrenvoll|honourably
bedeutend|major, substantial
die Leistung , -en|the performance, the achievement
abziehen|(1) to remove (2) to deduct (3) to subtract (4) to withdraw
der Pokal , -e|the trophy, the cup
die Auszeichnung , -en|the award, the accolade
der Gewinn , -e|(1) the profit (2) the asset (3) the gain
sich zurechtmachen|to groom oneself, to put make-up on (s~ z~)
verschmieren|to smear (v~)
glätten|to smooth
vorbereiten|to prepare (v~)
festlegen|to determine (f~)
die Prüfung , -en|the exam
rechnen|(1) to reckon (2) to calculate (3) to expect
der Untergang , -"e|the doom
mehrere|several (m~)
der Geist , -er|the ghost (Gei~)
rückwärtig|rear, rearwards (r~, *g)
durchsichtig|transparent
sich unterhalten|to chat, to converse (s~ u~)
gelegentlich|occasionally
der Mönch , -e|the monk
der Verruf , -|the discredit
die Halskrause , -n|the ruffle collar
die Strumpfhose , -n|the tights, the pantyhose
die Reihe , -n|the row, the line (R~)
anweisen|to instruct (a~)
das Blei|the lead (element) (no plural)
rotblond|strawberry blonde
einreihen|to queue (e~)
der Gänsemarsch|the single file (no plural)
fremdartig|unfamiliar, foreign, alien
tausend und abertausend|thousands and thousands (coll.)
die Kerze , -n|the candle
der Teller , -|the plate
der Kelch , -e|the chalice, the goblet
decken|to blanket, to cover
die Laterne , -n|the lantern
dunstig|hazy, damp, smoky (du~)
der Samt , -e|the velvet
übersät|strewn
verzaubert|spellbound, bewitched, entranced (v~)
verschlissen|worn, threadbare (v~)
hie und da|hither and thither (h~ u~ d~)
schmutzig|dirty (s~)
der Hase , -n|the hare
durch den Kopf schießen|to flash through one's mind (idiom) (d~ d~ K~ s~)
auf etwas hinauslaufen|to result in something, to come down to something (a~ e~ h~)
das Schweigen , -|the silence (Sc~)
der Riss , -e|the crack, the tear (R~, *s)
die Krempe , -n|the brim
auftun|to open up (*t*)
der Mund , -"er|the mouth
schlau|smart, shrewd (s~)
die Kappe , -n|the cap (K~)
der Jammerlappen , -|the whiner (J~)
der Bescheid , -e|the decision, the notification (B~, *d)
der Schädel , -|the skull
Bescheid wissen|to know the ropes, to know the score, to be glued up (B~ w~) (idiom)
regieren|to reign, to rule, to govern (r~)
die Tapferkeit , -en|the fortitude
der Mut , -|the bravery
treu|faithful, true
gerecht|fair, just, righteous
die Scheu , -en|the timidity, the awe, the fear (S~)
geschwind|swift (g~)
gelehrsam|booklearnt
die List , -en|the guile, the trickery, the subterfuge (L~)
die Tücke , -n|the pitfall, the guile, the peril (T~)
verbinden|to connect, to link, to merge, to tie together, to bind (v~)
der Beifall , -|the applause, the acclaim (B~)
spucken|to spit
der Ringkampf , -"e|the wrestling
der Troll , -e|the troll
anprobieren|to fit, to try on
schlagfertig|(1) glib (2) quick-witted
aufrufen|to invoke, to call up
der Zopf , -"e|the plait, the pigtail
der Jubel , -|the exultation, the jubilance, the cheering
unangenehm|unpleasant
verkünden|to declare, to proclaim
die Ewigkeit , -en|the eternity
tusend|roaring, tumultuous (t~)
das Gelächter , -|the laughter (G~)
entflammen|to inflame, to catch fire (e~)
die Begabung , -en|the aptitude, the talent (B~)
beweisen|to prove (b~)
tätscheln|to pat (t~)
erwidern|(1) to reciprocate (2) to respond, to answer
der Daumen , -|the thumb
eigenartig|peculiar, strange (e~)
wichtigtuerisch|pompous (w~)
die Freude , -n|the joy
der Schwachkopf , -"e|the moron, the idiot (S~)
der Krimskrams , -|the paraphernalia (K~)
unbekümmert|blithely, unconcerned
die Genie , -n|the genius
staunen|to marvel, to be astonished
überladen|overloaded, cluttered up
das Brathähnchen , -|the roast chicken
das Kotelett , -s|the chop, the cutlet
die Pellkartoffel , -n|the jacket potato
die Erbse , -n|the pea
die Bratensoße , -n|the gravy
der or das Ketchup , -|the ketchup (two genders)
wegnehmen|to take away, to snatch
häufen|to heap
köstlich|delicious (k~)
wahrhaft|truly, veracious (w~, *t)
zerschneiden|to cut into pieces (z~, *en)
zu Diensten|at your service (z~ D~)
vorziehen|to prefer (v~)
pikiert|peeved (p~)
unterbrechen|to interrupt, to disrupt
verdrossen|peevish, disgruntled, annoyed (v~)
der Sinn , -e|the sense, the mind
verlaufen|to proceed (v~, *l*)
kippen|to tilt, to tip (k~)
das Scharnier , -e|the hinge
köpfen|to behead, to decapitate
das Geschäft , -e|the business, the shop
husten|to cough
die Meisterschaft , -en|the championship
stierend|starring (vacantly), goggling (s~)
ausgemergelt|gaunt
silbrig|silverish, silvery (s~, *g)
bespritzen|to splatter, to splash (b~)
der Nachtisch , -e|the dessert (N~)
der Block , -"e|the block (B~)
erdenklich|conceivable, imaginable (e~)
der Sirup , -e|the syrup
die Torte , -n|the cake (T~)
der or das Biskuit , -s|the biscuit (B~) (two genders)
der Wackelpeter , -|the jelly
aufziehen|(1) to rear, to raise, to bring up (2) to approach, to pull up
auf der Hut sein|to be wary, to be on guard (idiom) (a~ d~ H~ s~)
die Magie , -n|the magic (M~)
pressen|to press, to squeeze
ertrinken|to drown
das Fußgelenk , -e|the ankle (*g*)
der Knöchel , -|the knuckle
anbieten|to provide, to offer (a~)
das Häuschen , -|the cottage
das Streichholz , -"er|the match, the matchstick
zum Beispiel|for example (z~ B~)
schläfrig|drowsy, sleepy
der Schluck , -e|the swallow, the gulp (of a drink etc)
fettig|greasy, fatty (f~)
die Hakennase , -n|the beaked nose, the hooknose
urplötzlich|extremely suddenly (u~)
Autsch!|Ouch!
abklingen|to subside, to fade away, to abate
auslösen|to trigger, to cause (au~)
die Unmenge , -n|the huge amount (U~)
nahelegen|to suggest (n~)
das Betreten , -|the entry, the access (B~)
das Stirnrunzeln , -|the frown
die Hymne , -n|the hymn
fuchteln|to wave about (f~)
verscheuchen|to banish, to scare away (v~)
der Faden , -"|the thread (F~)
das Warzenschwein , -e|the warthog
kahl|bald, bare, bleak (k~)
der Trauermarsch , -"e|the funeral march
dirigieren|to conduct, to direct (music) (d~)
bleischwer|heavy as lead
sich den Bauch vorschlagen|to stuff oneself (idiom) (s~ d~ B~ v~)
todmüde|knackered, dead tired
die Täfelung , -en|the panelling
der Wandteppich , -e|the tapestry
gähnend|(1) yawning (2) cavernous
der Spazierstock , -"e|the walking stick
grob|(1) rough, coarse (2) rude
die Rüstung , -en|the armor (R~)
sich die Acht nehmen|to be careful , to be aware (idiom) (s~ d~ A~ n~)
das Bildnis , -se|the effigy, the portrait
die Hilfestellung , -en|the assistance, the help, the support (H~)
gemütlich|cosy, snug (g~)
der Sessel , -|the armchair (S~)
geleiten|to usher, to guide (g~)
die Wendeltreppe , -n|the circular staircase
das Himmelbett , -en|the four-poster bed
Hau ab!|Get lost! Fuck off! (H~ a~)
das Laken , -|the bedsheet (La~)
überwechseln|to transfer, to change sides
die Zehenspitze , -n|the tiptoe
einen Blick erhaschen|to catch a glimpse of (e~ B~ e~)
beschäftigt|busy, occupied
die Höhe , -n|the height, the altitude (H~)
überspringen|to skip, to jump over
wiederum|again, on the other hand, however (w~)
das Porträt , -s|the portrait
die Kreide , -n|the chalk (Kr~)
der Zinken , -|the conk, the hooter (slang for nose)
der Kerker , -|the dungeon (K~)
drohen|to threaten
sperren|(1) to ban (2) to block (2) to baricade (3) to cage
die Kreatur , -en|the creature (K~)
quellen|to gush, to spring, to billow
lampenartig|lamp-like
patrouillieren|to patrol
der Korridor , -e|the corridor (K~)
pfeffern|(1) to chuck, to throw (2) to pepper (p~)
der Mittwoch , -e|the Wednesday
plump|awkward, clumsy, dumpy, plump
die Kräuterkunde , -n|the herbalism
züchten|to breed, to read, to cultivate
bei weitem|by far
leiern|to drone out
das Heft , -e|the notebook (H~)
verwechseln|to confuse, to mix up, to mistake
der Kauz , -"e|the coot, the codger, the old fogey
das Pult , -e|the lectern
verlesen|to read out loud, to lecture
loslegen|to get going, to get started
schenken|to bestow, to give a present (s~)
die Verteidigung , -en|the defense
der Vampir , -e|the vampire
lästig|annoying (l~)
sich jdn vom Hals schaffen|to get sb. off one's back (idiom) (s~ j~ v~ H~ s~)
meilenwert hinter|miles and miles behind
der Vorsprung , -"e|(1) the advantage (2) the headstart (3) the advance (4) the ledge, the projection (architecture)
sich verirren|to stray, to get lost (s~ v~,*rr*)
bevorzugen|to favor, to prefer (b~)
tags|by day (short form)
die Hausaufgabe , -n|the homework
jdm etwas aufhalsen|to lumber/saddle someone with something (j~ e~ a~)
umkreisen|to circle, to orbit
krakelig|scrawly (handwriting)
losschicken|to send off, to mail off
eingelegt|pickled, preserved
aufreihen|(1) to line up in a row (2) to string (beads etc)
die Berühmtheit , -en|the celebrity (B~)
kichern|to giggle
restlich|remaining, residue (r~)
die Brauerei , -en|the brewery
die Gabe , -n|(1) the talent (2) the gift (3) the knack
mühelos|effortless
das Gefuchtel , -|the gesturing
brodelnd|bubbling
zart|gentle, tender, delicate (za~)
die Vene , -n|the vein (V~)
betören|to infatuate
das Ansehen , -|the reputation, the prestige (A~)
zusammenbrauen|to concoct, to brew up
verkorken|to cork
ganz versessen auf|hellbent on, completely intent on (g~ v~ a~)
der Wermut , -|the woodworm
der Aufguss , -"e|the infusion
gerieben|grated, shredded
schnellen|to spring (sc~)
hämisch|gleeful (maliciously) (h~)
übersehen|to overlook, to fail to see
beschaffen|to purchase, to procure, to obtain (b~)
geringste|merest, least (g~)
meiden|to avoid, to shun (m~)
herbeten|to rattle off (h~, *b*)
missachten|to disregard, to neglect (m~)
auffangen|to catch, to pick up (a~)
zuzwinkern|to wink at
anblaffen|to snap at, to say in an angry/impatient voice
ergeben|to yield, to result in (er~)
der Schlaftrank , -"e|the nightcap (alcoholic drink) (S~)
bekannt|known (past-p.)
die Ziege , -n|the goat
bezeichnen|to denote, to designate
aufschreiben|to record, to write down
das Geraschel , -|the rustle, the rustling
die Heilung , -en|the healing, the cure
die Furunkel , -n|the boil
die Nessel , -n|the nettle
abwiegen|to weigh out (a~)
der Giftzahn , -"e|the poison fang
zermahlen|to grind, to mill (z~)
etwas auszusetzen haben|to have something to complain about (e~ a~ h~)
fordern|to demand (f~)
auffordern|to summon, to ask, to demand up (a~)
schmoren|to stew, to braise (s~)
unförmig|misshapen, shapeless (u~)
der Klumpen , -|the lump
das Gebräu , -e|the concoction, the brew (G~)
sickern|to seep, to trickle (s~)
vollspritzen|to squirt all over (v~)
zerspringen|to burst, to shatter (z~, *sp*)
verschüttet|spilled
der Schwung , -"e|(1) the momentum (2) the swing
das Stachelschwein , -e|the porcupine
der Stachel , -n|the spike, the stinger (of an animal)
fauchen|to hiss, to spit (f~)
vornehmen|to undertake (examination etc) (v~)
vermasseln|to goof, to blunder, to make a mistake (v~)
gemein|nasty, mean (g~)
emporsteigen|to climb up, to rise (e~)
miserabel|miserable (m~)
seinetwegen|because of him, on his account
sich auf den Weg machen|to hit the road, to set on one's way (idiom) (s~ a~ d~ W~ m~)
der Rand , -"er|the edge, the verge (R~)
die Armbrust , -"e|the crossbow
die Galosche , -n|the galosh (waterproof overshoe)
Mach Platz!|Make way! (M~ P~)
der Rüde , -n|the dog (R~)
das Halsband , -"er|the collar (for pets)
der Fasan , -e|the pheasant
die Flickendecke , -n|the patchwork quilt (F~)
losstürzen|to dash off (l~)
kochend|boiling
gießen|to pour (g~)
das Plätzchen , -|the biscuit (P~)
anmerken|to note, to remark (a~)
der Sabber , -|the drool
genießen|to enjoy (g~)
auf Schritt und Tritt|at every turn (idiom) (a~ S~ u~ T~)
raten|(1) to guess (2) to advise (r~)
prima|swell, great, neat (p~)
die Teehaube , -n|the teacozy
der Ausschnitt , -e|the extract, the excerpt, the cutout
der Einbruch , -"e|(1) the burglary (2) the breaking, the sudden onset
die Ermittlung , -en|the investigation, the inquiry (E~)
fortsetzen|to resume, to continue (f~)
allgemein|general, generally
der Vertreter , -|the representative
bekräftigen|to reinforce, to confirm (b~, *k*)
zufällig|random, accidental
Halt dich da raus!|Stay out of this! (idiom) (H~ d~ d~r~)
offiziell|official
der Zweifel , -|the doubt
die Höflichkeit , -en|the courtesy, the politeness
ablehnen|to refuse, to decline, to reject (a~, *l*)
der Stoff zum Nachdenken|the food for thought (d~ S~ z~ N~)
rechtzeitig|timely, on time
das Duell , -e|the duel
träumen|to dream
wenigstens|at least (w~)
das Schwarzes Brett|the blackboard, the notice-board (d~ S~ B~)
der Aufenthaltsraum , -"e|the lounge, the recreation room (A~)
sich lächerlich machen|to embarass oneself, to become a laughing stock (idiom) (s~ l~ m~)
vernünftig|reasonable, sensible, prudent (v~)
protzen|to show off, to flaunt (p~)
das Gerede , -|the gossip, the talk (Ger~)
ausgiebig|abundant, extensive, thorough (a~)
lauthals|full-throatedly, at the top of one's voice
langatmig|wordy, verbose, longwindedly (l~)
die Haaresbreite , -n|the hair's breadth
der Hubschrauber , -|the helicopter
entkommen|to escape (e~, *k*)
durchblicken|to understand, to see through
durchblicken lassen|to imply, to let, to express indirectly (d~ l~)
brausen|to roar (wind, water) (b~)
zusammenstoßen|to clash, to collide *z~, *ß*)
der Streit , -e|the argument, the row
spannend|exciting (s~)
anfeuern|(1) to encourage (2) to fire (e.g. an oven)
besteigen|to board, to mount
die Zahl , -en|the number, the figure (Z~)
erleiden|to sustain, to suffer, to incur (e~)
langweilen|to bore
der Wandel , -|the transition, the change (W~)
nachher|afterwards, later (n~)
die Ankunft , -"e|the arrival
daheim|at home (d~)
die Murmel , -n|the marble (toy bead)
erglühen|to glow, to blush deeply (e~)
insgeheim|secretly (i~)
der Ärger , -|the anger, the aggravation (Ä~)
vorgehen|to advance, to proceed, to go ahead
wellen|to wave, to undulate (we~)
abfallen|(1) to decrease, to drop, to fall away, to fall off (2) to slope, to slant
der Hang , -"e|(1) the slope (2) the tendency, the inclination (H~)
der Rasen , -|the lawn
aneinander|together, next to each other (a~)
sich über etwas mokieren|to tut at something, to mock something (s~ ü~ e~ m~)
vibrieren|to vibrate
der Drall , -e|the spin, the twist (*ll*)
der Falke , -n|the hawk, the falcon
Beeilung!|Hurry!
der Zweig , -e|the branch (Z~)
das Reisig , -|the brushwood, the deadwood
spreizen|to spread, to straddle, to splay (sp~)
der Stiel , -e|the stem, the shaft, the handle (S~, *l*)
aufpassen|to mind, to watch out for, to be careful
abstoßen|(1) to shed, to ditch (2) to push off
indem|whilst, while, as (i~)
die Lippe , -n|the lip
der Sekt , -e|the champagne (S~)
entschwinden|to disappear, to vanish (e~)
seitlich|lateral, sideways
Wumm!|Boom!
der Schlag , -"e|the blow, the strike
das Knacken , -|the snap (sound)
nach unten|down, downwards (n~ u~)
strömen|(1) to flock (to a place) (2) to flow, to run (river etc)
hinken|to limp, to hobble (hi~)
der or das Trampel , -|the klutz, the oaf, the plonker (Tr~) (two genders)
mit harten Zügen|hard-featured (face) (m~ h~ Z~)
ausgerechtnet du ...|you of all people ... (a~ d~)
die Heulsuse , -n|the crybaby
herab|down (he~, *b*)
der Zuruf , -e|the hail, the call
entgegnen|to counter, to reply
sich vorbeugen|to bend forward
auf etwas zuschießen|to hurtle towards something (a~ e~ z~)
der Speer , -e|the javelin, the spear
gen Erde|earthwards / to the ground (g~ E~)
die Zeitlupe , -n|the slow motion
der Sinkflug , -"e|the descent (flying) (S~)
hin und wieder|occasionally, every now and again (h~ u~ w~)
waagrecht|horizontal
wesentlich|crucial, essential (w~)
triumphierend|triumphant
verwiesen|expelled (from school etc)
voran|forth, ahead (v~, *an*)
mit jdm Schritt halten|to keep up with sb., to keep pace with sb. (m~ j~ S~ h~)
ohne auch nur|without even (o~ a~ n~)
dulden|to suffer, to tolerate, to allow (d~)
der Gehilfe , -n|the assistant (job) (G~)
ausleihen|to borrow (a~)
weisen|to indicate, to point out, to show (w~)
der Ausdruck , -"e|the expression
die Tafel , -n|(1) the board, the blackboard (2) the plate (3) the table
die Wüste , -n|the desert (W~)
fluchen|to swear, to curse (f~)
ratlos|baffled, clueless (r~)
forsch|forceful, brisk (speaking), outspoken (f~)
der Sturzflug , -"e|the nosedive (S~)
der Kratzer , -|the scratch
der Kapitän , -e|the captain
die Statur , -en|the stature, the build (S~)
anständig|decent (a~)
Weiß Gott!|God knows!
plattmachen|to murder, to wipe out (p~)
die Bestrafung , -en|the punishment (B~)
die Niere , -n|the kidney
schaufeln|to scoop, to shovel (s~, *auf*)
aus dem Häuschen sein|to be thrilled, to be giddy (idiom) (a~ d~ H~ s~)
klasse|boss, excellent
das Standbild , -er|the statue (*b*)
der Kriecher , -|the sneak (K~)
flankieren|to flank
die Mahlzeit , -en|the meal (*z*)
der Kumpel , -|the mate, the buddy
die Angelegenheit , -en|the matter, the issue (A~)
besprühen|to spray (b~, *u*)
der Schaden , -"|the damage, the harm, the detriment (S~)
ignorieren|to ignore
Von wegen!|As if! / My ass! (V~ w~)
egotistisch|egotistical
Es geht dich nichts an.|It doesn't concern you. (idiom) (E~ g~ d~ n~ a~)
trotz allem|despite everything
gelingen|to succeed (g~)
der Abschluss , -"e|(1) the graduation (2) the degree (3) the conclusion, the closure
der Ratschlag , -"e|the advice, the piece of advice
erteilen|to confer, to issue (e~)
anhängen|to attach, to add
abblocken|to stonewall, to block
wahrscheinlich|probably, likely
etwas aufs Spiel setzen|to put something at risk, to risk something (idiom) (e~ a~ S~ s~)
ständig|constantly (s~)
von Angesicht zu Angesicht|face-to-face (v~ A~ z~ A~)
sausen lassen|to skip, to not attend (s~ l~)
der Morgenmantel , -"|the dressing gown (M~)
hinab|down (hi~, *b*)
das Holzscheit , -e|the log of wood (for a fireplace)
gedrungen|stocky, thickset (g~)
die nächste Nähe|the close proximity (d~ n~ N~)
die Sorgenfalte , -n|the worry wrinkle (on a forehead)
unverschämt|outrageous, brazen, bold (u~)
sich einmischen|to intervene, to meddle (s~ e~)
die Gans , -"e|the goose
sich nicht um etwas scheren|to not care about, to not give a damn about (idiom) (s~ n~ u~ e~ s~)
sämtlich|(1) all (2) altogether (3) collected (s~)
so was von|royally (coll.) (s~ w~ v~)
ausgesperrt|locked-out, blocked, barred
einholen|to overtake, to outrun (e~)
bestätigen|to confirm (b~, *s*)
schnüffeln|to sleuth, to pry, to snoop
die Schnauze , -n|the snout
vorzeigen|to show, to produce (v~)
heil|whole, unhurt, safe and sound (h~)
sich hochrappeln|to climb to one's feet (idiom) (s~ h~)
gebieten|to demand, to command (g~)
die Vitrine , -n|the glass display cabinet (V~)
behalten|to retain, to keep (beh~)
Muffensausen haben|to be scared stiff (idiom) (M~ h~)
zusammenschrecken|to startle (z~)
lauern|to lurk, to lie in wait (l~)
packen|(1) to pack (2) to seize, to grip
tasten|to grope, to fumble (t~)
wegführen|to lead away
Hier entlang!|Along here! This way! (H~ e~)
endlos|endless
ausreichen|to suffice, to be enough (a~)
der Pfosten , -|the post,  the pole
noch ein|another (n~ e~)
etwas durchreißen|to tear something in half
der Behang , -"e|the hanging, the curtain (B~)
abhängen|(1) to depend (2) to outpace, to lose a pursuer
hervorstoßen|to gasp out words
prusten|to snort (p~)
zusammensinken|(1) to collapse (2) to slump to the ground
das Stechen , -|the twinge, the prickling
reinlegen|to screw, to con (r~)
der Tipp , -s|the tip, the hint
die Klinke , -n|the latch (K~)
das Quietschen , -|the squeak (Q~)
gackern|to cackle
stromern|to roam, to wander about, to prowl (str~)
brav|good, honest, virtuous (b~)
verpetzen|to snitch on
verschlagen|devious, shifty (v~)
zu deinem Besten|for your own good (z~ d~ B~)
Das war's!|That's it! (D~ w~)
aufdrücken|(1) to push open (door etc) (2) to imprint
in der Falle sitzen|to be trapped (idiom) (i~ d~ F~ s~)
verschließen|to seal, to shut (v~, *ß*)
das Mätzchen , -|the antic
nervig|annoying (n~)
fort|away (f~)
zupfen|(1) to pluck (2) to tug (z~)
der Ärmel , -|the sleeve (Ä~)
das Ungeheuer , -|the monster (U~, *g*)
rollen|to roll
irrsinnig|insane, crazy (i~)
zittern|to tremble, to shiver (z~)
sabbernd|slavering, drooling
der Fangzahn , -"e|the fang (F~)
glitschig|slippery, greasy, slick (g~)
der Speichel , -|the saliva (S~, *l)
hinweg|away (h~)
unmissverständlich|unambiguously (u~)
das Donnergrollen , -|the rolling thunder
über etwas hinwegkommen|to get over something (ü~ e~ h~)
nirgends zu sehen|nowhere to be found (n~ z~ s~)
sich kümmern|to care, to concern oneself with (s~ k~)
erhitzen|to heat (e~, *h*)
Das ist egal.|Nevermind. (D~ i~ e~) (idiom)
keuchen|to gasp, to pant (k~)
einsperren|to confine, to imprison (e~)
der Auslauf , -"e|the run, the animal enclosure
da unten|down there (d~ u~)
schöpfen|to scoop, to bucket (liquids) (s~, *ö*)
der Beitrag , -"e|the contribution (B~)
die Pfote , -n|the paw
entrüstet|indignant, enraged (en~)
trauen|to trust (t~)
gut gelaunt|cheerful, good tempered (g~ g~)
erpicht|eager, anxious, keen (erp~)
sich den Kopf zerbrechen|to rack one's brains, to agonise (idiom) (s~ d~ K~ z~)
der Aufwand , -"e|(1) the effort (2) the expenditure, the expense (Au~)
schützen|to protect (sc~)
wertvoll|valuable
der Anhaltspunkt , -e|the clue, the lead
erraten|to guess (e~)
das Interesse , -n|the interest (I~)
sich weigern|to refuse (s~ w~)
aufdringlich|intrusive, pushy
der Besserwisser , -|the know-it-all (B~)
verbuchen|to enter into the books (accounting) (idiom)
es jdm heimzahlen|to get back at somebody, to take revenge (e~ j~ h~)
per Post|by mail
der Speck , -e|the bacon
lauten|(1) to sound (2) to read (of a certain way) (l~)
verbergen|to disguise, to hide (v~, *b*)
neidisch|envious, jealous (n~)
zu zweit|as a pair (z~ z~)
versperren|to block, to obstruct (v~)
betasten|to feel, to examine by touch (bet~)
die Eifersucht|the jealousy (no plural)
widerstehen|to resist (w~)
protzig|swanky, showy
die Liga , die Ligen|the league (L~)
sparen|to save (money)
die Richtigkeit , -en|the correctness, the validity (R~)
der Umstand , -"e|the circumstance
eingehend|extensive, thorough (e~)
erläutern|to elucidate, to explain
verdanken|to owe (v~)
unterdrücken|to suppress, to blanket, to quell (u~)
unverhohlen|blatant, unconcealed (u~)
die Bestürzung , -en|the dismay
frohlocken|to rejoice (f~)
klauen|to swipe, to snitch, to steal (k~)
die Belohnung , -en|the reward (B~)
tönen|to chime, to sound (t~)
stapfen|to trudge, to walk with heavy steps
missbilligen|to disapprove
bloß|mere, merely, only (b~)
den Kopf in der Nacken werfen|to throw back one's head (idiom) (d~ K~ i~ d~ N~ w~)
schlendern|to stroll, to amble (s~, *l*)
die Bettdecke , -n|the duvet
schlank|slim
prägen|to coin, to mint, to shape, to emboss
die Aufschrift , -en|the inscription, the label (A~)
der Schweif , -e|the tail (S~, with long hair)
die Dämmerung , -en|the twilight, the dusk, and dawn
das Stadion , die Stadien|the stadium
die Tribüne , -n|the spectator stand, the terrace
befestigen|to fix, to fasten
das Geschehen , -|the event, the happening (G~)
verfolgen|to pursue, to follow (v~)
der Pfeiler , -|the pillar (P~)
die Seifenblase , -n|the soap bubble
anbringen|to mount, to fix, to attach (a~)
reagieren|to react (r~)
leicht|easy, light
der Korb , -"e|the basket
das Schlagholz , -"er|the wooden bat (cricket etc)
befreien|to free, to release (b~)
der Zickzack , -e|the zig-zag
festschnallen|to strap, to strap down
sich abmühen|to flounder, to struggle, to toil (s~ ab~)
der Treiber , -|the beater (hunting)
die Aufgabe , -n|the task, the assignment
gegnerisch|opposing, enemy (g~)
herunterspulen|to reel off (h~, *s*)
schon mal|once already, once before (s~ m~)
gebrochen|broken (g~)
der Kiefer , -|the jaw
spalten|to split, to cleave, to chop
hindurch|through (h~)
zusätzlich|additional
foulen|to foul (sports)
der Ersatz , -e|the replacement, the substitute (E~)
der Beutel , -|the pouch, the bag (B~)
ungemein|immensely (u~)
die Grundlage , -n|the foundation (G~)
beherrschen|(1) to dominate (2) to master (a subject)
der Geruch , -"e|the smell (G~, *u*)
der Gegenstand , -"e|the thing, the object, the subject (G~)
sich sehnen|to yearn (s~ s~)
so weit sein|to be ready (s~ w~ s~)
herüber|across (he~)
missmutig|sullen, discontented (mi~)
flink|swift, nimble, quick (f~)
schnipsen|to flick, to snap (fingers) (not 'schnippen')
wutschen|to whoosh (w~)
der Büffel , -|the buffalo
himmelwärts|skywards
anstacheln|to sting (a~)
die Windmühle , -n|the windmill
meckern|to bleat, to moan (m~)
Mach's doch selber!|Do it yourself! (idiom) (M~ d~ s~)
hundsmiserabel|abysmal, extremely bad, lousy (h~)
belebt|busy, lively
anstoßen|(1) to launch (2) to bump, to nudge
unbehaglich|awkward, uncomfortable (unb~)
dreinschauen|to look, to seem (d~)
das Festessen , -|the feast (F~)
ausschmücken|to embellish, to embroider
fegen|(1) to sweep (2) to move fast (f~)
verrutschen|to shift, to slip out of place, to become askew (verr~)
verzerren|to distort, to warp (v~, *z*)
ohnmächtig|unconscious (o~)
heillos|utter, hopeless (h~)
der Aufruhr , -e|the turmoil, the riot, the upheaval
die Anweisung , -en|the instruction, the direction (Anw~)
angeblich|allegedly, supposedly
der Streich , -e|the prank (St~)
immer wieder|again and again (i~ w~)
das Häufchen , -|the small heap
bahnen|to pioneer
verlassen|lonely, abandoned, deserted (v~)
der Greif , -e|the griffin
werdend|getting, becoming (w~)
die Schleife , -n|(1) the ribbon (2) the loop
das Schleifen , -|the grinding
bewegen|to move (b~)
der Fleck , -e|the spot, the patch, the stain (F~)
der Findling , -e|the boulder (Fi~)
das Wesen , -|the entity, the being, the creature (W~)
flach|flat (f~)
ausströmen|to emit, to radiate, to pour out
hölzern|wooden
die Keule , -n|the club, the mace (weapon) (Ke~)
linsen|to peek, to peep (li~)
das Hirn , -e|the brain (H~)
der Entschluss , -"e|the resolve, the decision (E~)
gemächlich|leisurely (*ä*)
beten|to pray
gleich wieder da sein|to be back in a flash (idiom) (g~ w~ d~ s~)
abschließen|(1) to lock (2) to complete, to conclude (a~)
panisch|paniced, panic-stricken
einstimmig|unanimous
aufstoßen|(1) to belch (2) to push open (a door)
liegend|lying, prone, recumbent
der Wasserhahn , -"e|the water faucet, the tap
schwerfällig|cumbersome
erblicken|to behold, to catch sight of (e~)
zögern|to hesitate (zö~)
das Rohr , -e|the pipe, the tube (R~)
zerren|to tug, to wrench, to drag (ze~)
die Raserei , -en|the frenzy
der Ausweg , -e|(1) the way out, the escape (2) the expedient
ohne Weiteres|automatically, just like that (o~ W~)
flutschen|to slip (undesired and of something slippery) (fl~)
hinein|in (hi~)
schlagen|to beat, to hit (s~)
scheußlich|atrocious (s~)
splittern|to splinter (s~)
wanken|to falter, to teeter (w~)
erschüttern|to jar, to jolt, to shake, to rock, to rattle (ers~)
beschmieren|to daub, to slather (b~)
klumpig|lumpy (k~)
der Kleber , -|the glue (K~, *r)
abwischen|to wipe off, to wipe away (a~)
aufhorchen|to listen attentively
veranstalten|to stage, to host (v~)
die Nachhut , -en|the rearguard
dahin|(1) to that place (2) lost
die Wut , -|the fury, the rage (W~)
von Glück reden können|to count oneself lucky (idiom) (v~ G~ r~ k~)
am Leben sein|to be alive (a~ L~ s~)
nachlaufen|to run after
mit etwas fertig werden|to deal with something, to handle, to manage (m~ e~ f~ w~)
verstoßen|to contravene, to do something against the law/rules
ebendies|the very same thing
verteilen|to distribute, to disperse (v~, *t*)
sich hinstellen|to position oneself (s~ h~)
verletzen|to injure, to harm (v~)
beenden|to finish (b~)
ausgewachsen|mature, fully-grown (a~)
heilfroh|delighted (h~)
abgesehen von|apart from (a~ v~)
brummen|(1) to mutter (2) to hum (3) to drone (b~)
zugeben|to admit, to concede (z~)
peinlich|embarrassing (p~)
erlegen|to cull, to slay (hunting) (e~)
schließen|(1) to close, to shut (2) to forge (a friendship) (3) to conclude (s~)
Das gehört dazu.|That is part of the deal. (idiom) (D~ g~ d~)
der Umkreis , -e|the perimeter (U~, *k*)
allmorgendlich|every morning
mit Reif bedeckt|covered with frost (m~ R~ b~)
der Maulwurf , -"e|the mole (animal)
das Fell , -e|the hide, the fur
der Pelz , -|the pelt, the fur
der Biber , -|the beaver
entfrosten|to defrost
die Partie , -n|(1) the game (sport) (2) the party
erobern|to conquer, to seize, to capture (e~)
bislang|up to now, as of yet (b~, *l*)
durchsickern|to seep through, to trickle through
ankündigen|to announce (ank~)
die Matratze , -n|the mattress
ansetzen|to schedule (a~)
erfahren|(1) to experience (2) to learn (e~)
begehen|to commit (crime etc.) (b~)
selten|seldom, rare
der Schiedsrichter , -|the referee (S~)
beschwören|to invoke, to conjure (b~)
herauf|up (he~)
rücken|to move (r~)
schuldbewusst|guilty (s~, *w*)
die Lektion , -en|the lesson, the unit (L~)
abschreiben|(1) to copy (in writing), to transcribe (2) to deduct (3) to write off (a~)
morgige|tomorrow's
das Schauspiel , -e|(1) the play, the drama (2) the spectacle
hochziehen|to hoist, to pull up, to raise (ho~)
zerfleischen|to mangle, to rend, to tear into pieces (z~, *c*)
die Binde , -n|the bandage (Bi~)
das Biest , -er|the beast (Bi~)
achten auf|to watch out for, to pay attention to (a~ a~)
stehlen|to steal
jdm etwas zutrauen|to think somebody is capable of doing something (j~ e~ z~)
hinter etwas her sein|to be after something, to be out for something (idiom) (h~ e~ h~ s~)
surren|to whirr, to buzz (su~)
vertreiben|to dispel, to chase away (v~)
fröhlich|cheerful, happy (f~)
derer|of those
sich auf etwas freuen|to look forward to something (s~ a~ e~ f~)
jdm zureden|to persuade somebody (j~ z~)
die Kraft , -"e|the force, the strength, the power (K~)
auslaugen|to exhaust, to wear out, to leech out
zusehen|to see, to watch (z~)
der Rang , -"e|(1) the rank, the tier (2) the spectator stand, the gallery
das Fernglas , -"er|the binoculars
oben|aloft, up (o~)
trotzdem|still, yet, nevertheless (t~)
unermüdlich|relentless, tireless
ruinieren|to ruin (r~)
das Spruchband , -"er|the banner (S~)
malen|to paint
der Löwe , -n|the lion
das Leuchten , -|the luminescence, the brilliance, the glow
zustimmen|to agree (z~)
auswendig|by heart
das Weh , -e|the woe, the pain (W~)
der Umkleideraum , -"e|the changing room (*ra*)
nachgeben|(1) to indulge (2) to relent (3) to give way, to yield (pressure etc)
der Anfeuerungsruf , -e|the shout of encouragement, the sports chant
vor allem|above all, especially, particulary (v~ a~)
die Ader , -n|the vein (A~)
die Augenwinkel , -n|the corner of the eye, the canthus
gellend|shrill, piercing (g~)
ertönen|to sound, to ring out (e~)
auffallend|striking, noticeable (a~, *nd)
der Torwart , -e|the goalkeeper
die Parade , -n|(1) the parade (2) the save (football)
der Besitz , -e|the property, the possession (B~)
geschickt|skillful (g~, *s*)
auseinanderhalten|to distinguish, to keep/tell apart
buchstäblich|literal, literally (b~)
verfehlen|to miss (e.g. a target), to fail, to neglect, to tumble
der Hals , -"e|the neck (H~)
null|(1) nil (2) zilch (coll)
auf der sicheren Seite sein|to be on the safe side (idiom) (a~ d~ s~ S~ s~)
die Ausschau , -en|the lookout (A~, *u)
das Anzeichen , -|the evidence, the indication, the sign (A~)
etwas mit jdm absprechen|to coordinate/agree something with someone (e~ m~ j~ a~)
angreifen|to attack (a~)
der or das Looping , -s|the loop (aviation) (two genders)
sich Luft machen|to let off steam, to vent something (idiom) (s~ L~ m~)
das Gemurmel , -|the muttering, the murmur
fallen lassen|to dump down, to let fall, to drop (f~ l~)
die Begeisterung , -en|the enthusiasm, the excitement (B~)
Kopf an Kopf|neck and neck (idiom) (K~ a~ K~)
zulegen|to gain, to put on (z~)
trudeln|to spin, to corkscrew (aviation) (t~)
wutentbrannt|wrathful, infuriated (w~, *b*)
der Wurf , -"e|the throw, the toss
auf den Platz schicken|to field (sports) (a~ d~ P~ s~)
Partei ergreifen|to take sides (P~ e~)
der Betrug , -"e|the fraud, the deception, the scam (B~)
empörend|outrageous (e~)
Schon gut.|All right. / Relax. (idiom) (S~ g~)
schlingern|to swerve, to roll (s~)
der Bruchteil , -e|the fraction (B~, *t*)
gehorchen|to obey (g~)
steuern|to steer (s~)
der Schlenker , -|the swerve, the detout
jubeln|to rejoice, to cheer (j~)
schweifen|to ramble, to roam, to rove
kopfüber|headfirst, head long
gewählt|chosen (g~)
züngeln|(1) to dart, to flicker (flames) (2) to french kiss
der Saum , -"e|the hem, the seam
aufheulen|(1) to rev (engine) (2) to howl
absaugen|to exhaust, to siphon, to suck off
das Gefäß , -e|the vessel, the jar, the receptacle (G~)
hinsehen|to have a look, to take a look
schluchzen|to sob
auf allen vieren|on all fours (a~ a~ v~)
die Verwirrung , -en|the confusion, the bewilderment
glückselig|blissful
ausrufen|to exclaim, to proclaim, to call out
der Herd , -e|the stove, the cooker (H~)
das Griechenland|(the) Greece
jdm etwas abkaufen|to buy something from someone (j~ e~ a~)
grummelig|grumpy, grouchy (gru~)
die Ansicht , -en|the view, the opinion (An~)
grottenfalsch|totally wrong (gro~)
erregen|to arouse (sexually), to excite, to stir
angehen|(1) to approach, to tackle, to address (a problem etc) (2) to concern
sauer|(1) sour (2) angry, annoyed
vor der Tür stehen|to be just around the corner (idiom) (v~ d~ T~ s~)
hüllen|to drape, to wrap (h~)
zufrieren|to freeze over (z~)
gesund pflegen|to nurse back to health (g~ p~)
die Ferien|the holiday, the vacation (F~, plural only)
losgehen|to go off, to begin
der Sturm , -"e|the storm (S~)
zugig|draughty (z~)
beißend|biting, cutting, acrid
der Schleier , -|(1) the veil (clothing) (2) the haze, the shroud
der Nebel , -|the fog (N~)
zusammenziehen|to contract, to tighten, to narrow, to draw together
Es tut mir leid.|I am sorry.
erwünscht|desired, wished-for, welcome
zerreiben|to grind, to pulverise (z~)
die Fischgräte , -n|the fishbone
empört über|indignant at (em~ ü~)
die Niederlage , -n|the defeat (N~)
die Heiterkeit , -en|the exhilaration, the mirth, the amusement (H~)
verbreiten|to distribute, to spread (v~, *b*)
der Vorschlag , -"e|the suggestion, the proposal
bocken|to buck (bo~)
eifersüchtig|jealous (e~)
verhöhnen|to ridicule (v~)
eintragen|to register, to record, to enter
die Tanne , -n|the fir (tree)
Nö.|Nope. (coll.) (2)
dehnen|to widen, to stretch wider (d~)
der Palast , -"e|the palace
der Vergleich , -e|the comparison (V~)
herausfordern|to challenge (h~)
die Schlägerei , -en|the brawl (S~)
ölig|oily, greasy (ö~)
knirschen|to grind, to crunch (teeth) (k~)
umwerfend|gorgeous, stunning (u~)
festlich|festive
die Girlande , -n|the garland
der Mistelzweig , -e|the mistletoe
turmhoch|towering (t~)
strebsam|assiduous, ambitious (s~)
ersparen|to spare, to save (ers~)
außer|(1) except (2) unless
matt|(1) faint, dull (2) weary (m~)
hasten|to scurry, to hasten
die Aufnahme , -n|(1) the intake (2) the admission (3) the recording (4) the reception
verdienen|(1) to deserve (2) to earn
zeitgenössisch|contemporary (z~, *ö*)
schier|sheer, mere, pure (s~)
das Fachgebiet , -e|the subject, the field of expertise
der Titel , -|the title
nach Luft und Laune|at a whim (idiom) (n~ L~ u~ L~)
hinüber|across, over (hi~)
schriftlich|written (s~)
die Erlaubnis , -se|the permission (E~)
behandeln|to treat, to approach, to handle (b~)
fortgeschritten|advanced (in skills or time) (f~, *g*)
der Bibliothekar , -e|the librarian
der Staubwedel , -|the feather duster
bereuen|to regret (ber~)
vereinbaren|to arrange, to agree on (v~)
das Wunder , -|(1) the wonder (2) the marvel, the miracle
belegen|(1) to prove (2) to attend (a course) (3) to occupy, to seize
rösten|to toast, to roast (r~)
spießen|to skewer (s~)
der Pfannkuchen , -|the pancake
schmieden|to forge (material) (s~)
der Plan , -"e|(1) the plan, the scheme (2) the plain
das Schach|the chess (no plural)
die Schlacht , -en|the battle (S~)
ramponieren|to ruin, to bedraggle (ra~)
der Nachteil , -e|the disadvantage, the drawback
widersprüchlich|contradictory (w~)
der Springer , -|(1) the knight (chess) (2) the jumper
verzichten|to quit (v~, *z*)
der Heiligabend , -e|the Christmas Eve
die Rübe , -n|the turnip
krakeln|to scrawl, to scribble (kra~)
schnitzen|to carve (wooden objects)
die Flöte , -n|the flute, the recorder
der Zettel , -|the piece of paper, the slip, the note, the bill (Z~)
beifügen|to enclose, to add (b~)
die Form , -en|the shape (F~)
selbst gebacken|home-baked
fließend|(1) fluent (2) flowing (3) floating
die Falte , -n|the fold
dämpfen|to dampen, to curb, to muffle, to soften
der Stoff , -e|(1) the substance, the matter (2) the fabric
weben|to weave
ehrfürchtig|reverent, awestruck
Ganz bestimmt.|Most certainly. For sure. (G~ b~)
ausstoßen|(1) to emit (fumes, smoke) (2) to utter (a shout etc.)
der Fuß , -"e|the foot
das Spiegelbild , -er|the reflection (in a mirror)
freilich|admittedly (f~)
vollends|completely (vo~, *ds)
abstreifen|to shed, to remove, to strip off (a~)
verschlungen|entwined
die Aufbewahrung , -en|the storage, the retention
die Lust , -en|the pleasure, the joy, the inclination (Lu~)
herumreichen|to circulate, to pass around
herrlich|marvelous, superb (he~)
halbherzig|half-heartedly
zusammengeknäuelt|balled-up, bundled-up
verbiegen|to bend, to twist (v~, *b*)
hocken|to perch, to crouch, to hunker (h~)
fesseln|(1) to shackle, to bind (2) to captivate, to grip
der Truthahn , -"e|the turkey
niedlich|cute, dainty (n~)
die Schüssel , -n|the bowl (S~)
sahnig|creamy
der Bratensaft , -"e|the gravy (using juice from the meat) (*f*)
schwächlich|wimpy, puny
der Kram , -|the stuff, the junk (K~)
knittrig|creased
das Hütchen , -|(1) the cone (2) the little hat
das Knallbonbon , -s|the christmas cracker
verziert|crested, ornamented
die Haube , -n|the cap, the bonnet, the hood (H~)
flambiert|flambé
das Dutzend , -e|the dozen
der Kasten , -"|the box, the chest, the cabinet (Ka~)
der Schmaus , -"e|the feast, the treat (S~)
verfroren|frozen, chilled through (v~)
einweihen|to inaugurate, to open (officially)
kläglich|pitiful, miserable (k~)
vor dem Schlafengehen|before going to bed (v~ d~ S~)
schlüpfen|(1) to slip (out of a room etc) (2) to hatch (s~)
der Aufenthalt , -e|the stay, the layover (A~)
quaken|to quack, to croak (q~)
tarnen|to camouflage (t~)
anzünden|to ignite (a~)
Schauer über den Rücken laufen|to send shivers down one's spine (idiom) (S~ ü~ d~ R~ l~)
die Kordel , -n|the drawstring, the cord (K~)
der Bereich , -e|(1) the area (2) the realm (3) the domain (B~)
trennen|(1) to separate, to segregate (2) to divorce (t~)
bilden|to form (b~)
die Nackenhaare sträuben|to make one's hair stand up on end (idiom) (d~ N~ s~)
vernehmen|(1) to hear (2) to examine (a witness) (v~)
mühsam|arduous, with difficulty (m~, *m)
das Blut gefrieren lassen|to make one's blood run cold (d~ B~ g~ l~)
ununterbrochen|uninterrupted, sustained
das Trommelfell , -e|the eardrum
zerreißen|to tear (to pieces) (z~)
umstoßen|to overturn, to overthrow
wirr|(1) confused (2) tangled (3) crazed (w~)
erstarren|to grow stiff, to solidiy, to freeze, to congeal
fliehen|to flee, to escape (fl~)
die Küche , -n|the kitchen
die Abkürzung , -en|(1) the abbreviation (2) the shortcut
prallen|to collide with, to bounce (p~)
die Linke , -n|the left
lehnen|to lean
wahrnehmen|to perceive (w~)
die Klaue , -n|the claw, the talon (Kl~)
reich|rich
verzieren|to garnish, to adorn (v~)
schwinden|to wane, to fade (s~)
die Panik , -en|the panic
wirbeln|to swirl (wi~)
hämmern|to pound, to beat, to hammer
vorhin|earlier (v~)
spiegeln|to reflect (mirror) (s~)
die Eigenart , -en|the quirk, the characteristic property (E~)
unmittelbar|immediate, immediately (u~)
die Leere , -n|the void, the emptiness
zur Besinnung bringen|to bring to one's senses (z~ B~ b~)
die Toten|the dead (plural)
Schade.|Too bad. Pity. (S~)
Wen kümmert es?|Who cares? (W~ k~ e~)
gleichgültig|indifferent
die Hexe , -n|the witch
das Alter , -|the age (A~)
die Streiterei , -en|the arguing (S~)
abhalten|(1) to deter (2) to keep out (3) to give (presentation) (4) to hold (meeting)
verwenden|to employ, to use (v~)
das Wissen , -|the knowledge (W~)
verzückt|ecstatic (v~)
wahnsinnig|insane (w~)
jemals|ever (j~)
sich auskennen|to know a lot about, to be well informed (s~ a~)
begehren|to desire
überzeugen|to convince
der Koffer , -|the suitcase
räumen|to vacate, to clear (r~)
der Wahnsinn , -|the insanity (W~)
schwanken|to fluctuate, to sway (s~)
die Enttäuschung , -en|the disappointment
durchblättern|to browse (books etc), to leaf through
der Dauerregen , -|the constant rain
besessen|(1) obsessed (2) possessed
schlammig|muddy (s~)
immerzu|incessantly, constantly (i~)
der Unfug , -|the mischief
der Schlamm , -e|the mud
landen|to land (l~)
jdm eins auswischen|to get one over somebody, to score off somebody (idiom) (j~ e~ a~)
beisammen|together (b~)
jdm guttun|to benefit someone, to be good for someone
konzentrieren|to concentrate (k~)
schleierhaft|baffling, opaque, incomprehensible (s~, *t)
klemmen|to bind, to clamp (kl~)
schleppen|to drag (s~, *p*)
üben|to practise (ü~)
wühlen|to dig, to burrow, to rummage (w~)
allerletzt|very last (adj.)
die Tasche , -n|(1) the bag (2) the pocket
stinkig|stinking
brummig|grumpy (b~)
zuschieben|to push towards
sich mit etwas befassen|to deal with something (a theme), to be concerned with (s~ m~ e~ b~)
die Herstellung , -en|the manufacture
zeugen|(1) to beget (2) to father, to sire (z~)
das Elixier , -e|the elixir
unsterblich|immortal, undying
angesehen|eminent (an~)
der Liebhaber , -|the aficionado, the lover
die Oper , -n|the opera
herausschaffen|to bring out (*ff*)
der Werwolf , -"e|the werewolf
der Biss , -e|the bite
kommend|coming, upcoming
nervös|nervous
die Vorstellung , -en|(1) the notion (2) the imagination (V~)
traumhaft|dreamlike, delightful, divine
parteiisch|partisan, biased
zulassen|to permit, to approve, to allow (z~)
jdm über den Weg laufen|to cross somebody's path (idiom) (j~ ü~ d~ W~ l~)
die Folter , -n|the torment (F~)
tröstlich|comforting (t~, *l*)
kaum etwas|barely anything (k~ e~)
ermutigen|to encourage
die Klammer , -n|(1) the bracket (2) the clamp
die Umkleidekabine , -n|the changing room, the fitting room (*ka*)
unter Dach und Fach|in the bag (idiom) (u~ D~ u~ F~)
ehe|before (e~)
kreuzen|to cross
deinesgleichen|people like you, your sort, your equals (d~)
zum Zerreißen gespannt sein|stretched to breaking point (z~ Z~ g~ s~)
der or das Knäuel , -|the knot, the ball (*ä*) (two genders)
der Rekord , -e|the record (R~)
in Führung liegen|to be in the lead (i~ F~ l~)
umarmen|to hug, to embrace
vortrefflich|sublime, excellent (v~)
Gut gemacht!|Well done! (G~ g~)
verbittert|embittered
die Besenkammer , -n|the broom cupboard
blutverschmiert|blood-smeared
der Schuppen , -|the shed
aufleuchten|to flash, to flash up
untergehend|sinking (u~)
vermummt|hooded
erringen|to gain, to win, to achieve (err~)
raubtierhaft|predatory (ra~)
der Wipfel , -|the treetop (W~)
die Buche , -n|the beech (tree)
die Lichtung , -en|the glade, the clearing
stottern|to stammer, to stutter (sto~)
das Untier , -e|the beast, the monster (U~, *t*)
der Feind , -e|the enemy (F~)
das Gleichgewicht , -e|the equilibrium, the balance (G~)
verpflichten|to oblige, to commit
die Kapuze , -n|the hood (K~)
unbeweglich|immobile, motionless (u)
bewusstlos|unconscious (b~)
Es wird schon wieder.|It will be OK. (idiom) (E~ w~ s~ w~)
der Schutz , -e|the protection (S~)
das Rückgrat , -e|the backbone (R~)
der Buckel , -|(1) the hump, the hunch (2) the hunchback
immer wenn|every time (i~ w~)
tadeln|to rebuke, to criticize
das Stottern , -|the stammer
der Zeitplan , -"e|the timetable, the schedule (Z~)
die Wiederholung , -en|(1) the repetition (2) the retaking (3) the repeat (4) the revision
gesamt|entire, whole (ge~)
die Notiz , -en|the note, the memo
anstreichen|to paint (walls etc.) (a~)
barsch|harsh, brusque (ba~)
wozu|why, what for (wo~)
büffeln|to cram (for exams) (b~)
annähernd|approximately, roughly (a~)
nicht annähernd|not nearly, nowhere near (n~ a~)
aufzählen|to enumerate, to list (a~)
entspannen|to relax (e~)
merken|to notice, to realize (m~)
sich etwas merken|to memorize, to learn (s~ e~ m~)
sehnsüchtig|longing, yearning
das Vergissmeinnicht , -e|the forget-me-not (flower)
fehl am Platz wirken|to seem out of place, to seem like a fish out of water (f~ a~ P~ w~)
die Neugier , -|the curiosity
misstrauisch|leery, wary, suspicious of (m~)
quasseln|to jabber (q~)
nachsehen|(1) to peek (2) to check, to have a look (n~)
das Gesetz , -e|the law (G~)
die Zucht , -|the breeding
zähmen|to tame
der Grünling , -e|the greenfinch
walisisch|welsh
vertuschen|to camouflage, to conceal (v~)
das Wiesel , -|the weasel
der Brei , -|the puree, the mash, the paste
Hör mal!|Listen! (H~ m~)
der Bann , -e|the spell (B~)
fummeln|to fiddle, to fumble (f~)
zocken|to gamble
veraltet|obsolute, outdated (v~)
beatmen|to ventilate, to give artificial respiration to  (med) (b~)
der Schnaps , -"e|the booze, the schnapps
stochern|to poke (s~, *c*)
geruhsam|peaceful, leisurely (g~)
ausarbeiten|to elaborate
fuchsteufelswild|furious (f~) (coll.)
schwänzen|to skip school
entfernt|(1) remote, distant (2) away (from a place)
breitschlagen|to persuade (br~)
begrüßen|to welcome (b~)
plumpsen|to flop
verschrumpelt|shrivelled (v~)
knochig|bony
dünnhäutig|thin-skinned, sensitive
die Nüster , -n|the nostril (Nü~) (animals)
der Stummel , -|(1) the stub (2) the butt (cigarette) (2) the stump (leg, arm)
orangerot|tangerine (colour) (o~)
schnappen|to snap, to snatch
größtenteils|largely (g~)
abdunkeln|to dim, to darken (a~)
jdm Vernunft beibringen|to talk some sense into somebody (idiom) (j~ V~ b~)
die Vernunft|the reason, the rationality, the sanity (no plural)
dreifach|threefold, treble
der Kringel , -|the curl, the 'O' (K~)
vernachlässigen|to neglect, to disregard, to ignore (v~)
die Pflicht , -en|the duty, the obligation
der Anspruch , -"e|(1) the claim, the right (2) the demand, the requirement (3) the aspiration, the pretension
aussetzen|to abandon, to release, to maroon (aus~)
die Wildnis , -se|the wilderness
genial|ingenious, brilliant
einverstanden|content, in agreement
zäh|tough, chewy (z~)
körbeweise|by the basketfull
sich betütteln|to get tipsy (s~ b~) (coll.)
das Häschen , -|(1) the bimbo (2) the bunny
das Schmusetier , -e|the cuddly animal (S~)
vorwerfen|to blame, to reproach (v~)
gesteckt|stuck (ges~)
mitgenommen|haggard, exhausted (m~)
der Haken , -|(1) the hook (2) the snag, the hidden difficulty
ratsam|advisable
die Wahl , -en|(1) the election (2) the choice
anfühlen|to feel, to touch (anfü~)
verprügeln|to batter, to pummel, to beat up (v~)
besänftigen|to placate, to calm down
heiser|hoarse
verbunden|associated, related (v~)
schnaufen|to wheeze, to puff, to breathe heavily (s~)
klirren|to clink, to clash (kl~)
einsam|lonely (e~)
schaurig|scary (s~)
hieven|to heeve (hi~)
der Umriss , -e|the outline (of an object) (U~)
das Schottenmuster , -|the tartan (pattern)
ausgemacht|(1) arranged, agreed (2) absolute, outright
die Stirn haben|to have the nerve (idiom) (d~ S~ h~)
froh|glad, happy
der Stepptanz , -"e|the tapdance
sich lustig machen|to make fun of, to tease (s~ l~ m~)
das Geschirr , -e|(1) the dishes, the crockery (2) the harness
basteln|to craft, to tinker, to make (b~)
aufhängen|to suspend, to hang
unterbringen|to accomodate, to house, to shelter, to stable
hanebüchen|outrageous, incredible (ha~)
die Vertuschung , -en|the cover-up
der or das Schlamassel , -|the mess, the strew-up (two genders)
sich herauswinden|to wiggle out of, to weasel out of (s~ h~)
gutheißen|to endorse, to approve (g~)
geschweige denn|let alone, not to speak of (g~ d~)
aufbauen|to build up, to put up, to establish, to arrange
der Pantoffel , -n|(1) the slipper (2) the clog (P~)
irgendein|some, any (*ei*)
aufbinden|to untie, to unlace (a~)
locken|to lure, to entice (l~)
tollpatschig|clumsy (t~)
dermaßen|so much (d~)
sich schämen|to feel ashamed (s~ s~)
zunichtemachen|to ruin, to destroy (hopes, dreams, etc) (zu~)
wiedergutmachen|to rectify, to compensate for, to put right (w~)
kein Auge zumachen|to not get a wink of sleep (idiom) (k~ A~ z~)
trösten|to comfort, to console. to solace (t~)
bange|apprehensive, fearful (ba~)
das Stundenglas , -"er|the hourglass (St~)
anzeigen|to display, to indicate (a~)
der Held , -en|the hero
schulden|to owe (s~)
spionieren|to spy, to do espionage
die Nase voll haben|to be fed up with, to have had enough of (idiom) (d~ N~ v~ h~)
der Rücktritt , -e|the resignation
lenken|to steer, to direct (l~)
das Elend|the misery (E~) (no plural)
die Zutat , -en|the ingredient (Z~)
die Erinnerung , -en|the memory (E~)
der Aufstand , -"e|the insurrection, the uprising, the rebelllion
jüngst|recent (j~)
unerwartet|unexpected (une~)
die Probe , -n|(1) the test (2) the rehearsal (3) the sample
sacht|softly, gently (sa~)
verklingen|to fade away (sound) (verk~)
mithören|to listen to, to overhear (m~)
mit federnden Schritten|with a spring in one's step (idiom) (m~ f~ S~)
der Beweis , -e|the proof, the evidence (B~)
erfinden|to invent
der Mond , -e|the moon
die Vorschrift , -en|the regulation, the rule (V~)
schielen|to squint (s~)
Es ist jammerschade.|It's a real shame (E~ i~ j~)
anwenden|to use, to deploy (a~)
die Handschelle , -n|the handcuff (H~)
die Kette , -n|the chain (K~)
einfetten|to grease (e~)
worin|in what
der Hornochse , -n|the stupid ass, the numbskull, the blockhead (Hor~)
allerlei|all kinds of, all sorts of, sundry, various (a~, *ei)
der Köcher , -|the quiver (for arrows)
der Pfeil , -e|the arrow
das Morgengrauen , -|the dawn, the daybreak (M~, *g*)
die Genugtuung , -en|the gratification, the satisfaction (G~)
der Anflug , -"e|(1) the descent, the landing (planes) (2) the touch of, the whiff of (A~)
etwas ausgefressen haben|to have been up to something (mischief) (coll.) (e~ a~ h~)
oder so was|or something (o~ s~ w~)
zerzausen|to ruffle up, to tousle (hair)
vom Schmerz erlösen|to release from pain (v~ S~ e~)
die Furcht|the dread, the fear (F~) (no plural)
verbannen|to banish (v~, *b*)
jdm etwas zuleide tun|to harm somebody (j~ e~ z~ t~)
der Feigling , -e|the coward
die Gabelung , -en|the fork (on a path etc.)
das Geschöpf , -e|the creature (G~)
das Moos , -e|the moss
bewachsen|vegetated
der Stumpf , -"e|(1) the stump (2) the stub
plätschern|to lap, to splash, to babble (water) (plä~)
spannen|to tense something, to cock (eg a crossbow) (s~)
schussbereit|ready to fire
ganz in der Nähe|at close quarters (g~ i~ d~ N~)
rascheln|to rustle, to crinkle (ras~)
rötlich|ruddy, reddish
der Zentaur , -en|the centaur, the horse-man
melancholisch|melancholic
der Mars|(the) Mars (planet) (no plural)
der/die Unschuldige(r)|the innocent (adj. decl.)
bergen|(1) to salvage, to recover (2) to hide, to harbour, to hide
verdrießlich|grumpy, morose (v~)
entlocken|to elicit (e~)
der Sterngucker , -|the stargazer
Aufhebens machen|to make a fuss (A~ m~)
der Huf , -e|the hoof, the hooves
Nee!|Nope! (coll.) (3)
das Unterholz|the undergrowth (U~) (no plural)
egal|indifferent (e~)
der Seufzer , -|the sigh
die Rückkehr|the return, the comeback (*kk*) (no plural)
zum Scherz|for fun (z~ S~)
heran|near, closer to the speaker/object (h~)
gewandt|skillful, nimble, deft (gew~)
der Spritzer , -|the splash
verquer|awry, askew (v~)
staksen|to stalk (s~)
die Wunde , -n|the wound
gelähmt|petrified, paralyzed (g~)
verspüren|to feel (v~)
vorüber|past, over (v~)
eindrucksvoll|impressive, striking (e~)
der Saphir , -e|the sapphire
verweilen|to linger, to dwell (v~)
bläulich|blue-ish
reiten|to ride (a horse)
die Scham|the shame (no plural) (S~, *m)
das Maultier , -e|the mule
der Eid , -e|the oath
ablegen|(1) to put down, to lay (2) to file, to store (3) to take off (clothes) (4) to give up, to abandon
der Esel , -|the donkey
streunen|to stray, to roam (s~)
verraten|to betray, to tell, to reveal (v~)
etwas hinter sich lassend|outpacing something (e~ h~s~ l~)
mahnen|to admonish, to warn, to caution
grauenhaft|atrocious (g~)
abschlachten|to slaughter, to slay (a~)
schutzlos|defenceless, vulnerable (s~)
meucheln|to murder (me~)
sprenkeln|to mottle, to sprinkle spots of
bewirken|to cause (bew~)
einnicken|to nod off (sleep) (e~)
wachrütteln|to wake (w~, *ü*)
durchtränken|to soak (completely) (d~, *tr*)
belauschen|to overhear (b~)
deswegen|(1) because of it (2) therefore
die Einmischung , -en|the interference, the meddling  (Ei~)
die Offenbarung , -en|the revelation (O~)
der Trost|the solace, the consolation (no plural)
die Wahrsagerei , -en|the fortune telling
der Ableger , -|the offshoot, the branch (Ab~)
pinnen|to pin (p~)
Nur für den Fall.|Just in case. (idiom) (N~ f~ d~ F~)
überstehen|to withstand, to get through, to survive (ü~)
zweifellos|undoubtedly
putzmunter|chipper, perky (p~)
schwül|sticky, close (weather)
schummeln|to cheat (s~)
die Ananas , -se|the pineapple
die Schnupftabakdose , -n|the snuffbox
die Dose , -n|the can
die Vergesslichkeit , -en|the forgetfulness
stechend|sharp, stinging (of pain)
der Ausflug , -"e|the trip, the excursion (A~)
altbekannt|renowned (al~)
schrullig|quirky, odd
das Zeugnis , -se|(1) the testimony (2) the certificate (3) the report (4) the mark (school)
sonnendurchflutet|sun-drenched
pilgern|(1) to pilgrimage (2) to make one's way
der Benimm|the manners (etiquette) (no plural)
eifrig|eager (e~)
pauken|to cram, to learn intensively (p~)
hinterher|afterwards, in hindsight, behind (h~, long)
der or das Tentakel , -|the tentacle (two plurals) (T~)
der Tintenfisch , -e|the squid, the octopus (T~)
ufernah|near-shore
sich suhlen|to wallow (s~ s~)
abgeschnitten|(1) cut off, clipped (2) trapped
abreißen|to demolish, to knock down (a~)
im Stich lassen|to betray, to leave high and dry (idiom) (i~ S~ l~)
die Aufzeichnung , -en|the written record, the outline
eben|(1) even (2) level (3) just, just now (4) simply
der Abhang , -"e|the slope (A~)
sehnlich|fervent, fond, eager (s~)
der Lehnstuhl , -"e|the armchair (L~)
enthülsen|to shuck, to pod (peas etc.)
etwas aufbehalten|to keep something on (e~ a~)
etwas spendieren|to splash out on, to spend extravagantly (e~ s~)
der Schoßhund , -e|the lapdog
das Entsetzen , -|the horror (E~)
beben|to quiver, to tremor (b~)
abreisen|to depart (on a journey)
gerade eben|just now (g~ e~)
häufig|often, frequent (h~)
die Vorsicht|the caution, the prudence (V~) (no plural)
etwas fahren lassen|to let go of something (e~ f~ l~)
versichern|(1) to assure (2) to insure
die Lage , -n|the location (L~)
die Ahnung , -en|the idea, the clue, the hunch, the suspicion
dafür sorgen|to make sure (d~ s~)
nachahmen|to imitate
überwachen|to monitor, to observe
fehlschlagen|to backfire
rausgeschmissen werden|to get the axe (idiom) (r~ w~)
dem Erdboden gleichmachen|to level to the ground (d~ E~ g~)
abseits|apart, on one side
hinnehmen|to acquiesce, to accept, to put up with something (h~)
der or die Gleichmut , -|the equanimity, the serenity (G~) (two genders)
blättern|to browse (books etc.) (b~)
unternehmen|to undertake, to do
etwas einstecken|to pocket something (e~e~)
nicht nach etwas zumute sein|to not have the stomach for something (idiom) (n~ n~ e~ z~ s~)
eisern|(1) emergency (reserves) (2) iron (3) unyielding
vortreten|to step forward
arg|bad (a~)
voraus|ahead (v~, *s)
äußerst|extremely (ä~)
das Omen , - or Omina|the omen (two plurals)
der Fußtritt , -e|the kick (F~)
der Teppich , -e|the carpet
locker|(1) loose, slack (2) casual
das Gespenst , -er|the spectre, the ghost (Ges~)
abfangen|to intercept
vielmals|many times
Ich bin geschäftlich hier.|I'm here on business. (I~ b~ g~ h~)
belästigen|to harass, to molest, to annoy
etwas anlehnen|to leave something ajar (e~ a~)
eine schöne Bescherung|a nice mess (idiom) (e~ s~ B~)
eindringlich|haunting, urgently, powerfully, emphatically
knarren|to creak, to squeak (k~)
grollen|(1) to rumble (thunder) (2) to resent
der Wahn , -|the craze, the fad, the delusion
die Harfe , -n|the harp
torkeln|to totter, to lurch
tappen|to toddle
übrig|left, remaining
die Luke , -n|the hatch (L~)
der Aufschlag , -"e|(1) the impact, the crash (2) the tennis serve (3) the lapel
ertasten|to feel, to grope, to identify by touch (e~)
der Sturz , -"e|(1) the fall, the plunge (2) the downfall, the demise (3) the slump (S~)
etwas abfedern|to cushion something (from a landing etc.)
der Kläffer , -|the yapper (of a dog etc.)
die Meile , -n|the mile
aufwenden|to expend (a~, *w*)
die Ranke , -n|the tendril
etwas verschnüren|to cord something, to bind something up (e~ v~)
der Trieb , -e|(1) the drive, the instinct (2) the shoot, the sprout
sträuben|to bristle
die Schlinge , -n|the noose, the loop, the snare
die Brust , -"e|the chest, the breast
händeringend|desperately (h~)
kokeln|to play with fire (k~)
lockern|to loosen, to slacken
lösen|to solve (a problem) (l~)
rieseln|to trickle (water, sand, etc.) (rie~)
klimpern|to tinkle, to jingle (kl~)
die Grust , -"e or -en|the vault (tomb or crypt) (two plurals) (*st)
wölben|to arch, to curve
bösartig|malicious
geflügelt|winged (g~)
der Schwarm , -"e|the swarm
einfangen|to capture, to trap (ei~)
altmodisch|old-fashioned
pfeilschnell|like a shot, quick as an arrow
nicht umsonst|not for nothing (idiom) (n~ u~)
verborgen|concealed
der Wirbel , -|(1) the whirl, the vortex (2) the fuss, the kerfuffle
der Regenbogen , -|the rainbow
die Feder , -n|(1) the feather (2) the spring (coiled metal)
knicken|to crease
krachen|to crack (sound) (kr~)
einkreisen|to encircle
beschädigen|to damage (b~)
abtauchen|to disappear (a~)
die Rakete , -n|the rocket
widerspenstig|restive, stubborn, unruly (w~)
meißeln|to chisel (m~)
erschaudern|to cringe (e~)
der Ritter , -|the knight (R~)
behelmt|helmeted
der Läufer , -|(1) the bishop (chess) (2) the runner (3) the square rug
der Bauer , -|(1) the peasant (2) the farmer (3) the pawn (chess)
vorrücken|to proceed, to advance, to move forward (v~, *rr*)
schräg|slanting, skewed, at an angle
es mit der Angst zu tun bekommen|to take fright (idiom) (e~ m~ d~ A~ z~ t~ b~)
die Gnade , -n|the mercy
gekrümmt|bent, hunched (gek~)
anherrschen|to shout at, to bark at (anh~)
opfern|to sacrifice
jdn schachmatt setzen|to checkmate somebody (j~ s~ s~)
trödeln|to linger (t~)
sich verbeugen|to bow (s~ v~, *b*)
freigeben|to release (f~)
stürmen|(1) to pelt (rain etc.) (2) to storm (3) to charge
gegen etwas ankämpfen|to struggle against something (g~ e~ a~)
wieder auf die Beine kommen|to get back on one's feet (idiom) (w~ a~ d~ B~ k~)
Mach schon.|Come on. (M~ s~)
widerlich|disgusting, yukky, gross (w~, *ch)
tränend|watery, teary (t~)
massig|bulky, huge, massive (m~, *g)
jdm den Atem verschlagen|to take somebody's breath away (idiom) (j~ d~ A~ v~)
der Mörder , -|the murderer
zerstäuben|to sputter, to spray, to atomize, to vaporize (z~)
der Zwerg , -e|the dwarf, the midget (Z~)
bauchig|bulbous
die Schlauheit , -en|the shrewdness, the cunning, the cleverness
beängstigt|frightened (b~)
zitterig|shaky
verdächtig|suspicious (v~)
der Blickkontakt , -e|the eye-contact
ausrichten|(1) to align, to line up (2) to tell (3) to organize (4) to achieve
die Zeitverschwendung , -en|the waste of time
das Seil , -e|the rope (S~)
etwas um etwas wickeln|to wrap something around something (e~ u~ e~ w~)
jdm um Kopf und Kragen bringen|to bring somebody into danger (idiom) (j~ u~ K~ u~ K~ b~)
hereinlassen|to let in, to admit
ein Händchen für etwas haben|to have a knack for something (idiom) (e~ H~ f~ e~ h~)
der Verdacht , -"e|the suspicion
abschneiden|to crop, to chop, to cut off
versäumen|to omit, to miss, to fail to do (v~)
fertigbringen|to manage, to achieve (f~)
längst|long since, long ago, already (l~)
plappern|to blather, to babble (p~)
gleichmütig|serene, composed, imperturbable
jdm auf die Pelle rücken|to pester somebody (idiom) (j~ a~ d~ P~ r~)
einschüchtern|to intimidate (e~)
die Fessel , -n|the fetter, the shackle
die Aufmerksamkeit , -en|the attention
widmen|to devote
nebenher|alongside, at the same time
jdn bedrohen|to threaten somebody (j~ b~)
einfältig|simple-minded, silly
streben|to aspire, to strive, to pursue (s~)
der Diener , -|the servant (D~)
vergeben|(1) to condone, to excuse, to forgive (2) to award, to allocate (v~, *g*)
ungehalten|indignant (u~)
im Auge behalten|to keep an eye on (idiom) (i~ A~ b~)
dusslig|stupid (dus~)
jdn belügen|to lie to somebody (j~ b~)
einatmen|to inhale
unfasslich|unbelievable, uncomprehensible (unf~, *h)
reimen|to rhyme
abwickeln|(1) to unwind, to uncoil (2) to conclude, to deal with
sich auf dem Absatz umdrehen|to turn around on one's heel (idiom) (s~ a~ d~ A~ u~)
die Schlange , -n|the snake
das Nasenloch , -"er|the nostril (Na~)
stärken|to strengthen
erschaffen|to create, to fabricate (ers~)
schnarren|to buzz shrilly (s~)
anflehen|to beseech, to implore, to beg (a~)
der Lügner , -|the liar
rührend|touching, poignant (r~)
schätzen|(1) to estimate (2) to value, to appreciate
umsonst|free, costless (u~)
messerscharf|razor-sharp (m*, *f)
bersten|to burst, to crack (b~)
entzweibrechen|to break apart, to break in two
fiebrig|febrile
die Blase , -n|(1) the bladder (2) the balloon (3) the blister
der Hechtsprung , -"e|the full-length dive (H~)
entgeistert|flabbergasted (e~)
die Handfläche , -n|the palm (of a hand)
sich fortscheren|to clear off, to leave (coll.) (s~ f~)
tödlich|lethal, deadly
strecken|to stretch
unwillkürlich|involuntarily
die Brandblase , -n|the blister from a burn
nackt|(1) bare (of skin etc.) (2) naked
die Qual , -en|the agony, the anguish (Q~)
anhaltend|continuing, sustained (a~)
verschwommen|fuzzy, blurred (v~)
nicht ganz auf der Höhe|not up to snuff, not at one's best (idiom) (n~ g~ a~ d~ H~)
das Ereignis , -se|the event
der Stand , -"e|the stand, the stall, the booth (S~)
der Bewunderer , -|the admirer
zeichnen|to draw, to sketch
hygienisch|hygienic
beschlagnahmen|to seize, to confiscate (b~)
dazukommen|to reach, to arrive on the scene (d~)
die Anstrengung , -en|the effort, the exertion (An~)
zerstören|to destroy, to ruin
gründlich|thorough (g~)
der Schluss , -"e|the conclusion, the end
vorrätig|in stock, available (v~)
etwas regeln|to take care of something, to sort something out (e~ r~)
wie wenn|as if (w~ w~)
auf und davon|up and away (a~ u~ d~)
überlassen|to surrender, to relinquish, to abandon (ü~, *l*)
dem Tod überlassen|left for dead (d~ T~ ü~)
der Gefolgsmann , -"er|the acolyte, the follower (G~)
erweisen|(1) to prove (2) to show (3) to bestow (e~)
wie auch immer|anyway, howsoever (w~ a~ i~)
hinauszögern|to prolong, to delay (h~)
abwehren|to fend off, to repel
daher|hence, therefore, as a result
die Umsicht|the prudence (U~) (no plural)
die Nachsicht|(1) the leniency (2) the indulgence (N~) (no plural)
Herrje!|Crumbs!/Jesus! (H~)
der Stempel , -|(1) the seal (2) the stamp
der Ehrgeiz , -e|the ambition (E~)
die Seele , -n|the soul
das Gefallen , -|the pleasure (Gef~)
der Fenstersims , -e|the windowsill
Es traf sich, dass ...|It so happened that ... (E~ t~ s~ d~)
naschen|to nibble, to eat sweet things
etwas vertiefen|to deepen something (e~ v~)
sich bemühen|to try hard, to attempt, to strive (s~ b~)
quitt|even, quits, even-stevens, etc. (q~)
die Idee , -n|the idea (I~)
unter uns gesagt|between you and me (idiom) (u~ u~ g~)
Das will was heißen.|That is saying something. (idiom) (D~ w~ w~ h~)
das Erbrochene|the vomit (E~) (no plural)
seither|even since, since, since then (s~, *h*)
die Schwäche , -n|the weakness
lächelnd|smiling
das Ohrenschmalz|the earwax (no plural)
betteln|to beg (be~)
Meinetwegen.|Whatever. (M~)
drauf und dran sein, etwas zu tun|to be about to do something (idiom) (d~ u~ d~ s~, e~ z~ t~)
etwas bleiben lassen|to leave something alone, to give something a miss (e~ b~ l~)
unerhört|outrageous (une~)
aufregend|exciting (a~)
das Gerücht , -e|the rumour
aufreißen|(1) to tear open (2) to open wide (mouth, eyes, etc.)
vernichten|to annihilate (v~)
von der Rolle sein|to have lost it (idiom) (v~ d~ R~ s~)
das Vorbild , -er|(1) the model, the example (2) the role-model
aufpäppeln|to feed up, to nurse back to health (a~)
benachrichtigen|to notify, to inform (b~)
der Draht , -"e|the wire, the filament (D~)
auf Draht sein|to be on the ball (idiom) (a~ D~ s~)
bestimmt|(1) certain, definite (2) firmly, assertively (3) particular
bei Kräften sein|to be well (b~ K~ s~)
spitz|pointed, sharp
gefährden|to endanger
meiner Meinung nach|in my opinion (m~ M~ n~)
der Wicht , -e|the wretch, the goblin, the little creature (W~)
rausschmeißen|to sack, to fire (coll.) (r~)
der Gram|the grief, the sorrow (no plural) (G~)
die Reue|the remorse (no plural) (R~)
kullern|to roll (k~)
vergehen|to vanish, to pass, to go by
sich einkriegen|to calm oneself (s~ e~)
die Wagenladung , -en|the truckload
das Transparent , -e|the banner (T~)
ersterben|to die down (ers~)
ausgelassen|exuberant, lively, boisteous
der Schwefel|the sulphur (no plural)
das Geschwafel , -|the waffle, the blather
das Fußgetrappel , -|the patter of feet
etwas berücksichtigen|to consider something, to take something into account (e~ b~)
das Radieschen , -|the radish
der Sonnenbrand , -"e|the sunburn
verleihen|(1) to lend (2) to award, to bestow
einkehren|to come (peace and quiet)
der Einsatz , -"e|(1) the use, the deployment (2) the commitment (3) the inset, the tray, the compartment
begraben|to bury (b~)
unerschrocken|undaunted, intrepid
überragend|outstanding, superior (ü~)
tosen|to roar, to rage (sea) (t~)
der Gleichstand , -"e|the draw, the tied game (G~)
dekorieren|to decorate (d~)
gezwungen lächeln|to smile through gritted teeth (idiom) (g~ l~)
gegenüber|(1) opposite (2) towards
entfallen|(1) omitted (2) to lapse, to be cancelled (e~)
jdm entfallen|to slip one's mind, to forget (j~ e~)
wettmachen|to offset, to make up for (w~)
mit Hängen und Würgen|by the skin of one's teeth (idiom) (m~ H~u~ W~)
schwatzen|to chatter, to gossip (schw~)
einfahren|(1) to make (profits etc.) (2) to appoach, to drive in (train)
verhutzelt|gnarled, withered (person) (v~)
die Fahrkarte , -n|the ticket (F~)
das Gedrängel , -|the scramble, the pushing and shoving
ausdrücken|(1) to express, to put (2) to squeeze out
die Pelle , -n|the skin (potato, sausage, etc)
